Villa·Rosa笹 塚=Villa·Rosa Sasazuka
世贸大楼的那种双子=World Trade Center's Twin
圣 · 埃雷帝国=Holy Saint · Aire Empire
安德 · 伊斯拉=Ente Isla
安特 · 伊苏拉=Ente Isla
安特 • 伊苏拉=Ente • Isla
东鸟取荘高志良=Azumatori Koshiro
北斗七星月光舞=Bắc Đẩu Thất Tinh Nguyệt Quang Vũ
安德? 伊斯拉=Ente Isla
比利山电影公司=Billy Hill Pictures
真仪 塯 纱鸟=Magiru Satori
真仪 瑠 纱鸟=Magiru Satori
薇恩德鲁格雷特=Viradegurette
亚露露梅露露=Aletmerlot
以致魔王的势=Lucifer
伊迪亚贝尔纳=Idraben
克鲁涅利乌斯=Kelimaeste
剪刀手爱德华=Edward Scissorhands
名字永垂千秋=lưu danh ngàn đời
哆拉 A 梦=Doreamon
国宾夕发尼亚=Pennsylvania
天极九转心法=Thiên Cực Cửu Chuyển Tâm Pháp
奥古斯丁六世=Augustine Vi
威尔艾尔贝伦=Willgrata
安娜史塔西亚=Anastasia
帝奥古斯丁六=Augustine Vi
德兰山之魔兽=Mother-Of Warcraft
拯救大兵瑞恩=Giải Cứu Binh Nhì Ryan
斩妖灭魔剑诀=Trảm Yêu Diệt Ma Kiếm Quyết
朽木 冴 子=Kutsuki Saeko
格拉乌索拉斯=Callandor
梅赛德斯奔驰=Mercedes Benz
烈火天罡剑诀=Liệt Hỏa Thiên Cang Kiếm Quyết
瑟空達利 亞=Sacalifa
瞬间转移大法=Thuấn Gian Chuyển Di Đại Pháp
福布斯富豪榜=Forbes Rich List
艾鲁迪修特图=Alderaxtian
计都罗喉瞬狱=Dracula Prisoner
阿拔斯十一世=Abbas Xi
降魔金刚法力=Hàng Ma Kim Cương Pháp Lực
降龙罗汉西天=Hàng Long La Hán Tây Thiên
Yalia=Yalia
ハ 儿 ト=Hamar
九十九里滨=Kujūkurihama
九门连星阵=Cửu Môn Liên Tinh Trận
五雷正天诀=Ngũ Lôi Chính Thiên Quyết
亚力克拉斯=Arklass
亚多拉玛雷=Adramelech
亚美卢帝亚=Amikadea
亚鲁斯托罗=Ylian
伊布利德制=Ybrahimovi-pact
伊莉丝提亚=Vitasia
伊莉丝提雅=Vitasia
优克莉伍德=Eucliwood
伽尔塔夫特=Gralatan
佛朗西斯科=Francisso
侏罗纪公园=Jurassic Park
保尔奈利亚=Baquerade
保罗十六世=Paul Xvi
修罗绝天阵=Tu La Tuyệt Thiên Trận
克莉丝提亚=Crestia
克莉丝特亚=Kristianna
克里斯特尔=Christina
克里斯菲德=Christopher
克里斯蒂娜=Christina
克里斯蒂尔=Christina
八百谷合梨=Yaotani Gonashi
六极真魔功=lục cực chân ma công
内西奥提斯=Nextheris
凤凰书学院=Phượng Hoàng Thư Học Viện
凯尔贝洛斯=Cerberus
加利福利亚=California
加勒比海盗=Pirates Of The Caribbean
加布莉艾拉=Gabriella
华盛顿邮报=Washington Post
卡鲁塔基亚=Kalutaron
古利阿奈拉=Juliana Naire
古拉贝利昂=UltraBeltrion
史佩卢比亚=Sylphia
吉尔贝斯塔=Jilliberta
哈尔莫尼亚=Halmone
哥利戴鲁须=Koridisu
哥鲁摩谢尔=Scaladon
四十二章经=Tứ Thập Nhị Chương Kinh
四灵群妖阵=Tứ Linh Quần Yêu Trận
埃布鲁波尔=Alabaster
基尔贝吉塔=Corneau
基尔贝斯塔=Corneau
塞可達利亞=Sukran
塞巴斯蒂安=Sebastian
多利阿姆斯=Victarii
多拉法鲁伽=Delphia
大天罗神功=Đại Thiên La Thần Công
大慈大悲手=Đại Từ Đại Bi Thủ
天弓院真爱=Tenkuujin Sanae
天星失魂散=Thiên Tinh Thất Hồn Tán
天河群星阵=Thiên Hà Quần Tinh Trận
太清纯阳阵=Thái Thanh Thuần Dương Trận
太玄裂天道=Thái Huyền Liệt Thiên Đạo
头号通缉犯=Most Wanted
奥库达比亚=Acrabia
如意心魂剑=Như Ý Tâm Hồn Kiếm
安德伊斯拉=Ente Isla
安托瓦内特=Antoinette
对方小侯爷=Phương tiểu Hầu gia
小野妹子可=Onotokan
尤司塔西亚=Eustarcia
巴巴利提亚=Babarus
巴巴力提亚=Barbarus
巴纳夫世杰=Bathotor
巴鲁多米亚=Batolomeo
布莱德彼特=Brad Pitt
希尔巴里昂=Xavier
希莉露朵娅=Shilusta
希鲁巴里欧=Xanthous
帝菲蘭提啊=Delantine
庐山不归路=Lư Sơn Bất Quy Lộ
弗朗西斯科=Francisco
弗雷姆哈特=Flemington
张 玥 朗=Trương Nguyệt Lãng
德兰山魔兽=Delanson Matheus
德拉基亚索=Digicabriar
德林柯沃特=Durling Tan Oak Wort
心禅不灭诀=Tâm Thiện Bất Diệt Quyết
慕容怀 嗪=Mộ Dung Hoài Quân
拉姆利亚斯=Lamurasi
拉斯维加斯=Florida
拉特克里夫=Ratcliffe
斯皮尔伯格=Spielberg
斯皮尔博格=Spielberg
斯马拉古帝=Simarian
斯马拉古迪=Simarian
易天十二诀=Dịch Thiên Thập Nhị Quyết
星川早少女=Hoshikawa Saotome
普利瑪麗亞=Palmyra
普力馬利亞=Primo
普洛米休斯=Polar Hughes
普罗米休斯=Polar Hughes
朵儿休白纳=Karabin
格鲁尼里奥=Gelando
梅丽艾斯特=Meleast
梅利菲斯特=Mfara
梅多菲斯特=Mfara
梅尔吉普森=Mel Gibson
梅莉艾斯特=Margarest
梅里莎莉姆=Melisalius
梅里菲斯特=Mfister
樱野玖璃梦=Sakurano Kurimu
比华利山庄=Beverly Hills
法兰西斯科=Francesco
法尔法雷洛=Farfarello
法诺瓦尔伯=Fanoran-Baer
波鲁艾哈鲁=Baloplus
波鲁艾斯恩=Balzack
派拉蒙等等=Paramount
特莱克瓦兹=Lakesoire
玄冰震魂诀=Huyền Băng Chấn Hồn Quyết
玄灵神火阵=Huyền Linh Thần Hỏa Trận
玛尔嘉利特=Marianne
玛纳勃朗西=Malacoda
玩龙珠游戏=Dragon Ball
瑟空達利亞=Sacalifa
瑟空遠利亞=Sacalifa
瓦尔基里亚=Walabria
瓦爾裘莉亞=Valedicte
石中焱炽铁=Thạch Trung Diễm Sí Thiết
神来恭太郎=Kamiku Kyoutaro
神龙定星阵=Thần Long Định Tinh Trận
科伦葛赞尔=Scaladon
科西嘉六世=Corsica Vi
索尔特利库=Soroth
纳萨尔艾路=Navarés
绝生十六式=Tuyệt Sanh Thập Lục Thức
罗伊埃鲁麦=Locile
罗伯特巴乔=Roberto Baggio
罗布斯切尔=Rabus Richer
罗德里格斯=Rodriguez
罗贝尔蒂奥=Valentia
耶鲁玛利亚=Almaria
艾尔多兰德=Argenta
艾斯佩利特=Alzerpelite
艾蕾欧诺拉=Elenora
艾路玛利亚=Almaria
苍云奇绝阵=Thương Vân Kì Tuyệt Trận
苏玛拉古迪=Sumaragudi
荼靡戒欢颜=Đồ Mỹ Giới Hoan Nhan
莱斯托尼亚=LaGafriwe
薩拉布里亞=Shuburian
蜜萨娜莉雅=Minamiya
血玉玲珑塔=Huyết Ngọc Linh Lung Tháp
贝尔菲尔德=Berfield
贝特罗修卡=Belfraxa
超级赛亚人=Siêu Xayda
达芬奇密码=The Da Vinci Code
迪 克西亞=Dicken
阿佛洛狄忒=Aphrodite
阿克迪奥斯=Kardstone
阿尔帕西诺=Al Pacino
阿尔忒弥斯=Artemis
阿尔谢埃尔=Alciel
阿尔达利亚=Nithrea
阿弗洛狄亚=Aphrodite
阿斯兰萨拉=Aslan
阿斯特利亚=Altoria
阿空加古拉=Jagualar
阿苏布瑞库=Sabriham
阿雷哈德罗=Privaro
降龙十八掌=Hàng Long Thập Bát Chưởng
雷姆路西尔=Luminator
露利露朵雅=Luudiva
青木堂香主=Thanh Mộc Đường Hương Chủ
青龙偃月刀=Thanh Long Yển Nguyệt Đao
馆衣本月穗=Yofuku Gessui
马克西莫斯=Maximos
马利安泰鲁=Madisto
马勒伯朗士=Malebranche
马勒布朗契=Malacoda
马尔多纳多=Maldonica
马纳勃郎西=Malacoda
高高的铁塔=Tháp Eiffel
鬼舞化魂阵=Quỷ Vũ Hóa Hồn Trận
魔龙惊天诀=Ma Long Kinh Thiên Quyết
鲁毕耶尔特=Luriette
鹤真心乃枝=Tsuruma Kokonoe
れい 亚=Lizia
一飞冲天=Nhất Phi Trùng Thiên
七叶真人=Thất Diệp Chân Nhân
七大圣门=Thất Đại Thánh Môn
七玄掌教=Thất Huyền Chưởng Giáo
七玄真人=Thất Huyền Chân Nhân
七界传说=Thất Giới Truyền Thuyết
万元归一=Vạn Nguyên Quy Nhất
万兽魔珠=Vạn Thú Ma Châu
万年树妖=Vạn Niên Thụ Yêu
万象玄尊=Vạn Tượng Huyền Tôn
三大神剑=Tam Đại Thần Kiếm
三尊魔煞=Tam Tôn Ma Sát
三浦日向=Miura Hinata
三潭印月=Tam Đàm Ấn Nguyệt
三眼怪兽=Tam Nhãn Quái Thú
三眼血魅=Tam Nhãn Huyết Mị
三眼龙狼=Tam Nhãn Long Lang
三色光柱=Tam Sắc Quang Trụ
三色魔眼=Tam Sắc Ma Nhãn
三间七界=Tam Gian Thất Giới
三间鬼域=Tam Gian Quỷ Vực
上官无错=Thượng Quan Vô Thác
上官追云=Thượng Quan Truy Vân
不死血厉=Bất Tử Huyết Lệ
不要帝王=Bất Yếu Đế Vương
东方世家=Đông Phương Thế Gia
东方天娇=Đông Phương Thiên Kiều
东方天骄=Đông Phương Thiên Kiêu
东方灵嫣=Đông Phương Linh Yên
东鸟取荘=Azumatori
中原七剑=Trung Nguyên Thất Kiếm
丹青剑侠=Đan Thanh Kiếm Hiệp
久鲁瓜创=Hishashi Sakusei
乌龙汤面=bát mì udon
乔治布什=George W. Bush
乙木真君=Ất Mộc Chân Quân
乙鹤道长=Ất Hạc Đạo Trưởng
九华地阴=Cửu Hoa Địa Âm
九天玄火=Cửu Thiên Huyền Hỏa
九天玄琴=Cửu Thiên Huyền Cầm
九字剑诀=Cửu Tự Kiếm Quyết
九幽令主=Cửu U Lệnh Chủ
九幽冥界=Cửu U Minh Giới
九幽巫术=Cửu U Vu Thuật
九幽炼魂=Cửu U Luyện Hồn
九现神龙=Cửu Hiện Thần Long
九缺老怪=Cửu Khuyết Lão Quái
九野大师=Cửu Dã Đại Sư
九阳重体=Cửu Dương Trọng Thể
九阴别府=Cửu Âm Biệt Phủ
九阴圣母=Cửu Âm Thánh Mẫu
九阴地灵=Cửu Âm Địa Linh
九阴洞府=Cửu Âm Động Phu
乾元真人=Càn Nguyên Chân Nhân
乾坤一剑=Càn Khôn Nhất Kiếm
乾坤天地=Càn Khôn Thiên Địa
乾坤玉璧=Càn Khôn Ngọc Bích
了尘大师=Liễu Trần Đại Sư
云之法界=Vân Chi Pháp Giới
云之法诀=Vân Chi Pháp Quyết
云界天尊=Vân Giới Thiên Tôn
云虚上人=Vân Hư Thượng Nhân
云雾老仙=Vân Vụ Lão Tiên
五彩仙兰=Ngũ Sắc Tiên Lan
五彩神针=Ngũ Sắc Thần Châm
五彩祥云=Ngũ Sắc Tường Vân
五行剑阵=Ngũ Hành Kiếm Trận
五角大楼=Lầu Năm Góc
五角星芒=Ngũ Giác Tinh Mang
亚乌萨尔=Yuusel
亚兹拿古=Arclarity
亚历克斯=Alex
亚历山大=Alexander
亚夫玛露=Cataphract
亚尔斯兰=Arsilan
亚尔莫赞=Maestan
亚斯葛伦=Aspérgen
亡灵尊主=Vong Linh Tôn Chủ
亡灵诅咒=Vong Linh Trớ Chú
人器合一=Nhân Khí Hợp Nhất
人头马来=Remy Martin
仙佛神魔=Tiên Phật Thần Ma
仙鸢星系=Tiên Diên Tinh Hệ
伊古夏斯=Ingrath
伊尔内斯=Doyle Martínez
伊底帕斯=Oedipus
伊莎贝拉=Isabella
伯勒努斯=Basilica
伽伊鲁恩=Galton
住谷夕树=Sumitani Nishiki
佛圣道仙=Phật Thánh Đạo Tiên
佛米卡姆=Formica
佛罗提斯=Fouros
佩尔尼亚=Pellegina
侵魂邪咒=Xâm Hồn Tà Chú
修布利顛=Shuburian
借尸还魂=Tá Thi Hoàn Hồn
倾城一刀=Khuynh Thành Nhất Đao
元婴初期=nguyên anh sơ kỳ
光之君主=Hikaru-sama
克兰纳德=Caranold
克劳蒂娅=Claudia
克塞库斯=Cercasus
克布拉戈=Kepriac
克拉丽莎=Clarissa
克拉露丝=Kadelusi
克洛伊茨=Kreuz
克罗伊兹=Kreuz
克罗伊茨=Kreuz
克莱斯勒=Chrysler
克莱门特=Clemente
克菈露丝=Kadelusi
克里斯汀=Christopher
克里米亚=Crimea
克雷古斯=Krebia
克雷布斯=Krebia
八眼奇兽=Bát Nhãn Kỳ Thú
八眼神兽=Bát Nhãn Thần Thú
六天麻耶=Rokuten Maya
六翼霜蚣=lục dực sương công
六脉神剑=Lục Mạch Thần Kiếm
兰斯洛特=Lancelot
军氏家族=Quân thị gia tộc
冰系仙术=Băng Hệ Tiên Thuật
冰雪神女=Băng Tuyết Thần Nữ
冰鱼鹰奈=Tanaka Hio
凡多利亚=Fardan
凡衣上人=Phàm Y Thượng Nhân
凤凰书院=Phượng Hoàng Thư Viện
凤凰火焰=Phượng Hoàng Hỏa Diễm
凤鸣九天=phượng minh cửu thiên
凯迪拉克=Cadillac
刚果惊魂=Cry Of The Congo
利比科古=Libidae
剪刀次郎=Scissors Jiro
加尔刚修=Galius
加尔穆斯=Gardine
加尔雷恩=Gardien
加连达尔=Garredor
加里波第=Garibadi
加长林肯=Lincoln
劳斯莱斯=Rolls-Royce
勾魂媚眼=Câu Hồn Mỵ Nhãn
匈野大汗=Hung Dã Đại Hãn
化魂大法=Hóa Hồn Đại Pháp
化魂归虚=Hóa Hồn Quy Hư
十万大山=Thập Vạn Đại Sơn
千世血咒=Thiên Thế Huyết Chú
千兽合体=Thiên Thú Hợp Thể
千刀万刮=ngàn đao vạn xẻo
千化玉郎=Thiên Hóa Ngọc Lang
千变玉郎=Thiên Biến Ngọc Lang
千妖灭神=Thiên Yêu Diệt Thần
千山一剑=Thiên Sơn Nhất Kiếm
千年树妖=Thiên Niên Thụ Yêu
千幻鬼魈=Thiên Huyễn Quỷ Tiêu
千影血魅=Thiên Ảnh Huyết Mị
千星夺魂=Thiên Tinh Đoạt Hồn
华兹利奥=Huziliao
华内达州=Las Vegas
华山一剑=Hoa Sơn Nhất Kiếm
单林海盗=hải tặc Đan Lâm
南荒莽龙=Nam Hoang Mãng Long
博司克斯=Brikedor
卡卡罗特=Kakalot
卡尔卡特=Carserch
卡尔洛斯=Garrosh
卡巴斯基=Kaspersky
卡托玛索=Karteau
卡拉利斯=Karlin
卡拉貝拉=Karabaul
卡拉赛修=Kalasor
卡斯托尔=Castor
卡桑德拉=Cassandra
卡迪亚斯=Kardier
卢西安诺=Luxiannuo
印第安纳=Indiana
厄斯提德=Estine
原罪系列=Sins Series
变形金刚=Transformers
古林伍德=Garande
古雷格里=Gregory
古鲁里昂=Graias
史客维尔=Neville
史特格尔=Shitegeer
司徒晨风=Tư Đồ Thần Phong
司马无风=Tư Mã Vô Phong
司马晨风=Tư Mã Thần Phong
合阳大师=Hợp Dương đại sư
吉利贝尔=Gillibel
吉尔福特=Forgull
名垂青史=lưu danh sử sách
吕克贝松=Luc Besson
哈利波特=Harry Potter
哈尔巴德=Haerbadier
哈根达斯=Haagen-Dazs
哈雷路亚=Hallelujah
哥伦比亚=Colombia
啸月天狼=Khiếu Nguyệt Thiên Lang
啸月神剑=Khiếu Nguyệt Thần Kiếm
喀迪尔斯=Kadier
噬心剑诀=Phệ Tâm Kiếm Quyết
噬血大法=Phệ Huyết Đại Pháp
噬血魔功=Phệ Huyết Ma Công
四九天劫=Tứ Cửu Thiên Kiếp
四佛六云=Tứ Phật Lục Vân
四尊魔煞=Tứ Tôn Ma Sát
四灵神兽=Tứ Linh Thần Thú
图塔蒂斯=Tartaros
土之目偬=Tsuchi Meisoi
圣彼得堡=St. Petersburg
圣手何飞=Thánh Thủ Hà Phi
圣瓦伦丁=Valentine
圣路易丝=St. Louise
地狱之火=Địa Ngục Chi Hỏa
地狱天使=Địa Ngục Thiên Sứ
地阴天煞=Địa Âm Thiên Sát
地阴邪灵=Địa Âm Tà Linh
域之三界=Vực Chi Tam Giới
基基吉鲁=Cocokaku
塔塔亚洛=Tatayaluo
塞特里奧=Satala
夏洛利库=Naclast
夏野梦见=Natsuno Yume
多米内斯=Martinez
多米尼克=Gargant
多纳泰罗=Donatello
多萝蕾丝=Dolores
夜月斩法=Dạ Nguyệt Trảm Pháp
大天使号=Archangle
大庆右相=Đại Khánh Hữu Tướng
大泽愁山=Osawa Yutsuoka
大罗诸天=Đại La Chư Thiên
天下两杰=thiên hạ lưỡng kiệt
天之三界=Thiên Chi Tam Giới
天剑九诀=Thiên Kiếm Cửu Quyết
天地同春=Thiên Địa Đồng Xuân
天地无极=Thiên Địa Vô Cực
天地至尊=Thiên Địa Chí Tôn
天地阴邪=Thiên Địa Âm Tà
天外流星=Thiên Ngoại Lưu Tinh
天威可鉴=Thiên Uy Khả Giám
天字帅令=Thiên Tự Suất Lệnh
天宿老道=Thiên Túc Lão Đạo
天宿道长=Thiên Túc Đạo Trưởng
天导爱莱=Tendou Renai
天幻邪云=Thiên Huyễn Tà Vân
天影血魅=Thiên Ảnh Huyết Mị
天星书院=Thiên Tinh Thư Viện
天残老祖=Thiên Tàn Lão Tổ
天河宝录=Thiên Hà Bảo Lục
天浩道长=Thiên Hạo Đạo Trưởng
天涯八剑=Thiên Nhai Bát Kiếm
天灯大师=Thiên Đăng Đại Sư
天灵剑气=Thiên Linh Kiếm Khí
天灵神剑=Thiên Linh Thần Kiếm
天煞厉魂=Thiên Sát Lệ Hồn
天痴道长=Thiên Si Đạo Trưởng
天绝七斩=Thiên Tuyệt Thất Trảm
天绝夺魄=Thiên Tuyệt Đoạt Phách
天绝斩法=Thiên Tuyệt Trảm Pháp
天绝邪神=Thiên Tuyệt Tà Thần
天罡剑诀=Thiên Cang Kiếm Quyết
天苍道长=Thiên Thương Đạo Trưởng
天蝉三式=Thiên Thiền Tam Thức
天蝉刀法=Thiên Thiền Đao Pháp
天蝉秘笈=Thiên Thiền Bí Cấp
天轮法王=Thiên Luân Pháp Vương
天都圣人=Thiên Đô Thánh Nhân
天钟道长=Thiên Chung Đạo Trưởng
天靖皇帝=Thiên Tĩnh Hoàng Đế
天风洞主=Thiên Phong Động Chủ
天魔教主=Thiên Ma Giáo Chủ
天鹏洞主=Thiên Bằng Động Chủ
天鹰洞主=Thiên Ưng Động Chủ
天龙禅唱=Thiên Long Thiện Xướng
太上老君=Thái Thượng Lão Quân
太平天国=Thái Bình Thiên Quốc
太阴蔽日=Thái Âm Tế Nhật
头条俊吾=Midashi Shungo
夺宝奇兵=Indiana Jones
奇尔提克=Kercelt
奇山四剑=Kỳ Sơn Tứ Kiếm
奇里亚科=Ciriatto
奔雷剑法=Bôn Lôi Kiếm Pháp
奥古斯丁=Augustine
奥布莱恩=O'brian
奥林匹克=Olympic
奥狄乌斯=Oddiust
奥茜莉亚=Aoxiliya
奥菈一世=Olae Gash
如云和尚=Như Vân Hòa Thượng
如云大师=Như Vân Đại Sư
如意仙娘=Như Ý Tiên Nương
如意神剑=Như Ý Thần Kiếm
妖皇裂天=Yêu Hoàng Liệt Thiên
妖魄真火=Yêu Phách Chân Hỏa
妙莉爱儿=Maudica
姆立艾尔=Mulier
姬萩红叶=Himeragi Koyo
威杰利亚=Wrakenia
娜塔莉娜=Natalie
娜塔西娅=Natalia
媞梅迪娜=Demeter
孤叶先生=Cô Diệp Tiên Sinh
宇文修岚=Vũ Văn Tu Lam
安吉丽娜=Angelina
安妮斯顿=Aniston Dayton
安德雷斯=Andres
安杜马利=Adramelech
安特卫普=Antwerp
安都洞主=An Đô Động Chủ
定天神针=Định Thiên Thần Châm
宝马奔驰=Mercedes-Benz
寂灭禅主=Tịch Diệt Thiện Chủ
密斯托林=Smith Torrington
寒冰剑气=Hàn Băng Kiếm Khí
察比埃尔=Charmelie
封灵阵法=Phong Linh Trận Pháp
少林八绝=Thiếu Lâm Bát Tuyệt
尤尤利娜=Yuriea
尤尤莉娜=Yuriea
尤斯提纳=Justina
尤斯缇娜=Justina
尤梅尔达=Yomelde
尤特里罗=Utrillo
尤莉安娜=Juliana
尼古拉斯=Nicolas
巧手郎君=Xảo Thủ Lang Quân
巨灵魔煞=Cự Linh Ma Sát
巴伐利亚=Bavaria
巴斯提亚=Baston
巴斯里奥=Bathosa
巴隆特里=Balongteli
布拉缇娜=Bilatina
布雷戈里=Bolossi
希利乌斯=Sirius
希尔维亚=Sylvia
希斯缇娅=Ylivia
希普尔特=Siphrean
希里乌斯=Sirius
帝菲蘭提=Delantine
席尔巴利=Ghirbali
幻兽洞天=Huyễn Thú Động Thiên
幻兽绝神=Huyễn Thú Tuyệt Thần
幻化之术=Huyễn Hóa Chi Thuật
幻梦流光=Huyễn Mộng Lưu Quang
幻象之术=Huyễn Tượng Chi Thuật
幽灵三煞=U Linh Tam Sát
库拉依弗=Krager
库雷布斯=Krebia
弗尔格尔=Foerger
弗朗西斯=Francis
弗里索斯=Fremnós
弥天剑阵=Di Thiên Kiếm Trận
弥天血罩=Di Thiên Huyết Tráo
归无道长=Quy Vô Đạo Trưởng
彩凤仙子=Thải Phượng Tiên Tử
影月双剑=Ảnh Nguyệt Song Kiếm
御女心经=Ngự Nữ Tâm Kinh
德利亚鲁=Drakan
德安学院=Đức An Học Viện
心剑无痕=Tâm Kiếm Vô Ngân
心欲无痕=Tâm Dục Vô Ngân
恩布里欧=Enbuliou
悖达罗士=Bedusci
情人山庄=Tình Nhân Sơn Trang
惊天剑诀=Kinh Thiên Kiếm Quyết
意念神波=Ý Niệm Thần Ba
慕容剑秋=Mộ Dung Kiếm Thu
慕容秋水=Mộ Dung Thu Thủy
慧觉神尼=Tuệ Giác Thần Ni
战心尊者=Chiến Tâm Tôn Giả
户也光男=Mitsuo
所向无敌=Sở Hướng Vô Địch
扎吾纳斯=Ragunasi
拂琴老者=Phất Cầm Lão Giả
拉伊德尔=Baliser
拉拉托亚=Laratia
拉格朗日=Lagrange
拉法埃罗=Lafalle
拉薇露娜=Lawerrger
拓拔牧宏=Thác Bạt Mục Hoành
拓跋牧宏=Thác Bạt Mục Hoành
拜因里希=Beinlich
控水大法=Khống Thủy Đại Pháp
控水心法=Khống Thủy Tâm Pháp
控火之术=Khống Hỏa Chi Thuật
提塔尼亚=Titania
提斯洛坞=Diretar
搜魂大法=Sưu Hồn Đại Pháp
摇曳夫人=Diêu Duệ phu nhân
斩风仙剑=Trảm Phong Tiên Kiếm
斩龙仙子=Trảm Long Tiên Tử
斩龙剑诀=Trảm Long Kiếm Quyết
断眉剑尊=Đoạn Mi Kiếm Tôn
斯乌鲁特=Siwrath
斯加勒缪=Socilary
斯芬克斯=Sphinx
斯贝兰卡=Spelunker
斯通韦尔=Stone Ware
斯雷特林=Sterling
方小侯爷=Phương tiểu Hầu gia
施瓦辛格=Schwarzenegger
无为道派=Vô Vi Đạo Phái
无位道派=Vô Vị Đạo Phái
无双公子=Vô song công tử
无头骑士=Dullahan
无量天尊=Vô Lượng Thiên Tôn
无间鬼煞=Vô Gian Quỷ Sát
无魂阴罗=Vô Hồn Âm La
时代周刊=Time Magazine
明月客栈=Minh Nguyệt Khách Sạn
星火燎原=Tinh Hỏa Liệu Nguyên
星球大战=Star Wars
星辰真火=Tinh Thần Chân Hỏa
普拉提那=Platina
普拉斯塔=Praviah
普拉缇娜=Platina
普拉蒂娜=Bilatina
暗影之门=Ám Ảnh Chi Môn
暗影流光=Ám Ảnh Lưu Quang
暗影蔽日=Ám Ảnh Tế Nhật
暗血首领=Ám Huyết Thủ Lĩnh
札伊库恩=Zharhen
札吉乌鲁=Drathas
杀戮之月=Sát Lục Chi Nguyệt
杜鹃醉鱼=Đỗ Quyên Túy Ngư
杰克耶尔=Jackyres
杰西卡五=Jessica
松原飞鸟=Matsubara Asuka
林宝坚尼=Lamborghini
柊 铃菜=Hiiragi Suzuna
查比埃尔=Charmelie
柳生一剑=Liễu Sanh Nhất Kiếm
格伦夏尔=Gronkjaer
格林纳达=Grenada
格里普斯=Griffon
格里高利=Gregory
格雷戈尔=Gregor
梅多里亚=Mfara
梅蒂媪丝=Medeleia
梅赛德斯=Mercedes
梦见系列=Dream Series
梵谧心经=Phạm Mật Tâm Kinh
椎名深夏=Shiina Minatsu
椎名真东=Shiina Mafuyu
欧尤克库=Augustian
欧尤果克=Orosheld
欧阳云天=Âu Dương Vân Thiên
欧阳道德=Âu Dương Đạo Đức
歌德巴赫=Goldbach
武宫唐那=Wardionia
武林书院=Võ Lâm Thư Viện
武林四友=Võ Lâm Tứ Hữu
死神之刀=Tử Thần Chi Đao
残响死灭=Echo of DEATH
残心魔煞=Tàn Tâm Ma Sát
比丝福汀=Brishing
比华利山=Beverly Hills
比欧尼萨=Brazaro
比蒙巨兽=Behemoth
水月洞天=Thủy Nguyệt Đỗng Thiên
水谷衣楠=Mizutani Kusunoki
永胜剑客=Vĩnh Thắng Kiếm Khách
沃鲁克库=Ulugthel
沛特西亚=Petercia
没有回答=không trả lời
泌莹仙子=Bí Oánh Tiên Tử
法姆多拉=Pharissa
法尔多拉=Pharissa
法布纳哈=Pharissen
法性大师=Pháp Tính Đại Sư
法果大师=Pháp Quả Đại Sư
法轮大师=Pháp Luân Đại Sư
法里奥斯=Faerie
法鲁托拉=Pharissa
波尔艾南=Boernite
波比诺卿=Babylon
波特莱尔=Bauderlaire
波西米亚=Bohemian
泣血魔魅=Khấp Huyết Ma Mị
泰坦尼克=Titanic
洛伊德卿=Jonoth
流云剑侠=Lưu Vân Kiếm Hiệp
浩云居士=Hạo Vân Cư Sĩ
浩天府主=Hạo Thiên Phủ Chủ
浩然天罡=Hạo Nhiên Thiên Cương
浩然正气=Hạo Nhiên Chính Khí
海尔赛兹=Hellscythe
海角天涯=Hải Giác Thiên Nhai
液晶电视=Lcd Tv
深蓝娱乐=Deep Blue Entertainment
混世魔王=Hỗn Thế Ma Vương
清木道长=Thanh Mộc Đạo Trưởng
清虚老道=Thanh Hư Lão Đạo
清虚道长=Thanh Hư Đạo Trưởng
清风行馆=Thanh Phong Hành Quán
清风阁主=Thanh Phong Các Chủ
湖海散人=Hồ Hải Tán Nhân
满天过海=Mãn Thiên Quá Hải
潘德拉刚=Pendragon
潘德拉贡=Pendragon
潜龙大陆=Tiềm Long Đại Lục
澳大利亚=Australia
灭天之威=Diệt Thiên Chi Uy
灭天斩法=Diệt Thiên Trảm Pháp
灭魂剑法=Diệt Hồn Kiếm Pháp
灵宝天尊=Linh Bảo Thiên Tôn
炼心神殿=Luyện Tâm Thần Điện
炼魂洞天=Luyện Hồn Động Thiên
烈日龙枪=Liệt Nhật Long Thương
烈火灵叟=Liệt Hỏa Linh Tẩu
烈火焚天=Liệt Hỏa Phần Thiên
烈火真元=Liệt Hỏa Chân Nguyên
烈火龙魂=Liệt Hỏa Long Hồn
烟雨江南=Yên Vũ Giang Nam
煎饼油条=Pancake
煞血阎罗=Sát Huyết Diêm La
燎原将军=Liệu Nguyên Tương Quân
燕南世家=Yến Nam Thế Gia
爱德华多=Eduardo
爱斯基摩=Eskimo
爱美拉达=Emeralda
爱莉西亚=Alicia
牵魂大法=Khiên Hồn Đại Pháp
特莱伊顿=Tereaton
特莱克罗=Teracia
特里斯坦=Tristian
独孤九天=Độc Cô Cửu Thiên
独孤动天=Độc Cô Động Thiên
独龙尊者=Độc Long Tôn Giả
狮面尊者=Sư Diện Tôn Giả
狮面魔尊=Sư Diện Ma Tôn
玄冥天罡=Huyền Minh Thiên Cương
玄冰之气=Huyền Băng Chi Khí
玄冰真劲=Huyền Băng Chân Kính
玄天剑阵=Huyền Thiên Kiếm Trận
玄天神剑=Huyền Thiên Thần Kiếm
玄心剑尊=Huyền Tâm Kiếm Tôn
玄月无双=Huyền Nguyệt Vô Song
玄欲神功=Huyền Dục Thần Công
玄灵异咒=Huyền Linh Dị Chú
玄灵神火=Huyền Linh Thần Hỏa
玄灵阴煞=Huyền Linh Âm Sát
玄玉真人=Huyền Ngọc Chân Nhân
玄空大师=Huyền Không Đại Sư
玄阴真人=Huyền Âm Chân Nhân
玄风特使=Huyền Phong Đặc Sứ
玄风门主=Huyền Phong Môn Chủ
玄鬼真人=Huyền Quỷ Chân Nhân
玉华真人=Ngọc Hoa Chân Nhân
玉波仙子=Ngọc Ba Tiên Tử
玉莲观音=Ngọc Liên Quan Âm
玉龙雪山=Ngọc Long Tuyết Sơn
玛格莉特=Margaret
玛路埃尔=Mardine
玛露蒂娜=Marilyne
环球速递=Global Express
珂妮莉亚=Khabiya
琳格兰媞=Rigtheau
琳格兰蒂=Rigurath
瑟鲁提斯=Seluti
瑶池圣女=Dao Trì Thánh Nữ
瑶池玉女=Dao Trì Ngọc Nữ
瓦伊巴恩=Wyvern
瓦伦迪亚=Waldica
瓦尔塔纳=Valforte
瓦恩菲尔=Wardfeller
生命之杯=Life Cup
白发老者=Bạch Phát Lão Giả
白眉神君=Bạch Mi Thần Quân
白鹿书院=Bạch Lộc Thư Viện
百毒蛇君=Bách Độc Xà Quân
的丘吉尔=Churchill
的罗斯福=Roosevelt
目前星系=Mục Tiền Tinh Hệ
看不出来=nhìn đoán không ra
真仪 塯=Magiru
真仪 瑠=Magiru
矢刳马心=Yakuma Kokoro
破空逐浪=Phá Không Trục Lãng
碧波烟霞=Bích Ba Yên Hà
碧绿剑庄=Bích Lục Kiếm Trang
神剑如意=Thần Kiếm Như Ý
神剑紫影=Thần Kiếm Tử Ảnh
神哭小斧=Thần Khốc Tiểu Phủ
神奇四侠=Fantastic Four
神奈川县=Kanagawa
神魔洞天=Thần Ma Đỗng Thiên
福尔图娜=Fortuna
离恨天宫=Ly Hận Thiên Cung
离恨天尊=Ly Hận Thiên Tôn
离散真人=Ly Tán Chân Nhân
秋月琴音=Shugetsu Kotone
秋月真岸=Tsuki Magishi
科林菲法=Colin
科波菲尔=Copperfield
移天大阵=Di Thiên Đại Trận
移相大法=Di Tương Đại Pháp
穆罕默德=Muhammad
空灵之界=Không Linh Chi Giới
空间跳跃=Không Gian Khiêu Dược
竹山四煞=Trúc Sơn Tứ Sát
符勒亚宏=Flachion
第一滴血=First Blood
第一高中=Trường Trung Học Số 1
第三高中=Trường Trung Học Số 3
米斯库尼=Musst
米特尼克=Mitnick
米菲斯特=Mifanite
紫华吞日=Tử Hoa Thôn Nhật
紫影神剑=Tử Ảnh Thần Kiếm
紫阳真人=Tử Dương Chân Nhân
红云太子=Hồng Vân Thái Tử
红云老祖=Hồng Vân Lão Tổ
红叶学姐=Akaba-sempai
红叶知弦=Akaba Chizuru
纳塔里奥=Natalia
织田信长=Oda Nobunaga
绝命刀客=Tuyệt Mệnh Đao Khách
绝尘仙子=Tuyệt Trần Tiên Tử
维多利亚=Victoria
维尼亚斯=Vinhas
绿袍双煞=Lục Bào Song Sát
缥缈仙子=Phiếu Miểu Tiên Tử
罗丝薇瑟=Luctavia
罗严塔尔=Luoyantaer
罗伯斯基=Luobosiji
罗多利柯=Lacraven
罗斯托克=Rostock
罗蕾伊雅=Roemas
罗贝尔特=LaBerte
翡翠狮子=sư tử phỉ thúy
联合航空=United Airlines
胧格兰蒂=Lucande
艾丽希雅=Leshia
艾佛列德=Alfrede
艾利欧斯=Ardson
艾尔克思=Albroke
艾尔埃德=Animos
艾尔西尔=Alciel
艾巴里特=Ebaron
艾流西昂=Alexey
艾琉希恩=Alexian
艾米丽娅=Amelia
艾米丽雅=Amelia
艾米利亚=Emilia
艾米莉亚=Emilia
艾米莉雅=Emilia
艾美拉达=Emeralda
艾美莉亚=Emilia
艾莉米亚=Amelia
艾莉西亚=Alicia
艾莉西雅=Ellicia
艾里希欧=Alexey
艾鲁多兰=Lidor
艾鲁罗伊=Heroult
芊芊夫人=Thiên Thiên phu nhân
芙莉索斯=Phrima
芙莉达因=Frieda
花前月下=hoa tiền nguyệt hạ
苏格兰场=Scotland Yard
苏菲米亚=Saphemia
茶堂元治=Satsu Motoharu
荒淫无道=hoang dâm vô đạo
荷鲁蒂亚=Heldina
莉莉亚诺=Liliane
莉莉西亚=Lilicia
莎士比亚=Shakespeare
莎米菲亚=Shamina
莫东海峡=eo biển Mạc Đông Hải
莱姆利斯=Limare
菩提学院=Bồ Đề Học Viện
菲亚丽丝=Filise
菲亚莉丝=Philiss
萨尔达尔=Sadaer
落霞山庄=Lạc Hà Sơn Trang
葛拉迪姆=Geladin
葛瑞妮丝=Gastrost
蒂德莉特=Derlite
蒂法尔特=Tiferet
蒂罗莉娜=Tyrolina
蒙罗丽莎=Mona Lisa
蕾媞西亚=Lashiria
虚无之力=Hư Vô Chi Lực
虚无法诀=Hư Vô Pháp Quyết
虚无空痕=Hư Vô Không Ngân
蜀山剑典=Thục Sơn Kiếm Điển
蜀山剑宗=Thục Sơn Kiếm Tông
血光虚无=Huyết Quang Hư Vô
血巫二煞=Huyết Vu Nhị Sát
血灵大阵=Huyết Linh Đại Trận
血界七绝=Huyết Giới Thất Tuyệt
血界尊主=Huyết Giới Tôn Chủ
血衣霸王=Huyết Y Bá Vương
裂日龙枪=Liệt Nhật Long Thương
西伯利亚=Siberia
西域老虎=Tây Vực Lão Hổ
西姆路克=Simarook
西尔维亚=Sylvia
西尔维娅=Silvia
西里亚特=Ciriatto
西门先生=Tây Môn Tiên Sinh
西门无痕=Tây Môn Vô Ngân
西门飞雪=Tây Môn Phi Tuyết
警铃阵法=Cảnh Linh Trận Pháp
计都罗喉=Dracula
诛魔九剑=Tru Ma Cửu Kiếm
诸葛不凡=Chư Cát Bất Phàm
诸葛小花=Chư Cát Tiểu Hoa
诸葛红袍=Gia Cát Hồng Bào
贝娜蒂塔=Benedetta
贝尔芬格=Berath
贝尔赛尔=Barcret
贝欧鲁夫=Bouxvar
赛尔西卡=Sarexia
赛巴斯塔=Bastar
赛莉安娜=Tangaria
赛雷西亚=Salencia
赤焰杀神=Xích Diễm Sát Thần
赫尔米娜=Halemina
赫尔米涅=Halemina
赫连以顷=Hách Liên Dĩ Khoảnh
赫连舞裳=Hách Liên Vũ Thường
超级男人=Super Man
路西 法=Lucifer
路西菲尔=Lucifer
达利亚斯=Dalias
达卡勒斯=Dhakaer
达达尼尔=Dardanelle
迈克尔贝=Michael Bay
连顿海姆=Lintorhelm
迪乌巴哲=Dirbache
迪亚布罗=Diablo
迪亚波罗=Diablo
迪克西亞=Dicken
迪兰达尔=durandal
迪斯洛乌=Diretar
迷你腊肠=Miniature Dachshund
追魂剑法=Truy Hồn Kiếm Pháp
逃命大法=Đào Mệnh Đại Pháp
逍遥神剑=Tiêu Dao Thần Kiếm
通天三图=Thông Thiên Tam Đồ
逝电九闪=Thệ Điện Cửu Thiểm
道邪残剑=Đạo Tà Tàn Kiếm
邪心书生=Tà Tâm Thư Sinh
邪心魅眼=Tà Tâm Mỵ Nhãn
邪气凛然=Tà Khí Lẫm Nhiên
都市系列=City Series
里滋贝特=Tugielt
重阳老人=Trọng Dương Lão Nhân
金刚圣佛=Kim Cương Thánh Phật
金刚降魔=Kim Cương Hàng Ma
金笛芙蓉=Kim Địch Phù Dung
金色宝塔=Kim Sắc Bảo Tháp
金蝉脱壳=Kim Thiền Thoát Xác
银河群星=Ngân Hà Quần Tinh
镜湖山庄=Kính Hồ Sơn Trang
长春掌教=Trường Xuân Chưởng Giáo
长眉头陀=Trường Mi Đầu Đà
问心真人=Vấn Tâm Chân Nhân
阴晴不定=âm tình bất định
阴阳五行=Âm Dương Ngũ Hành
阴阳法结=Âm Dương Pháp Quyết
阴阳法诀=Âm Dương Pháp Quyết
阿兹拉克=Arclarity
阿卡迪亚=Arcadia
阿基米德=Archimedes
阿姆尼尔=Armyste
阿尔伯特=Albert
阿尔卑斯=Alps
阿尔巴斯=Erbarst
阿尔帕伊=Alpay
阿库达鲁=Kredaught
阿德罗德=De Lione
阿舒夫鲁=Therean
阿莱斯达=Alistor
阿贾尼斯=Ajartine
阿鲁托鲁=Solinum
降魔九阵=Hàng Ma Cửu Trận
降魔金刚=Hàng Ma Kim Cương
除魔联盟=Trừ Ma Liên Minh
隆奇努斯=Longinus
隆达密司=Lodmetri
雁北五老=Nhạn Bắc Ngũ Lão
雁北双邪=Nhạn Bắc Song Tà
雅儿菲琳=Yafaline
雅德路德=De Lione
雅戈道格=Doug Jacobin
雅鲁梅多=Yalic
雪密菲亚=Saphemia
雪米菲亚=Saphemia
雪米菲娅=Saphemia
雷伊拉斯=Reizer
雷伊鲁兹=Luciel
雷克力欧=Lugrath
雷奥尼德=Leiaonide
雷恩哈特=Ryenhart
霍尔克斯=Alexey
霍格沃兹=Hogwarts
霍萨利斯=Hoist
霹雳雷豹=Phích Lịch Lôi Báo
青巫三圣=Thanh Vu Tam Thánh
静月大师=Tĩnh Nguyệt Đại Sư
靳云魔神=Cận Vân Ma Thần
韋格涅斯=Wirgen
风凰书院=Phong Hoàng Thư Viện
风城秀吉=Hideyoshi
风雷始动=Phong Lôi Thủy Động
风雷真君=Phong Lôi Chân Quân
风雷真诀=Phong Lôi Chân Quyết
飘天文士=Phiêu Thiên Văn Sĩ
飞星老道=Phi Tinh Lão Đạo
飞虹真人=Phi Hồng Chân Nhân
飞龙真人=Phi Long Chân Nhân
马努凯斯=Maniche
马来西亚=Malaysia
马纳果达=Malacoda
马里亚纳=Mariana
鬼帅幻魅=Quỷ Soái Huyễn Mị
鬼王战甲=Quỷ Vương Chiến Giáp
魔云天风=Ma Vân Thiên Phong
魔云神兽=Ma Vân Thần Thú
魔刀屠神=Ma Đao Đồ Thần
魔天尊主=Ma Thiên Tôn Chủ
魔幻尊主=Ma Huyễn Tôn Chủ
魔影千幻=Ma Ảnh Thiên Huyễn
魔灭其心=Ma Diệt Kỳ Tâm
魔煞真火=Ma Sát Chân Hỏa
魔神啸风=Ma Thần Khiếu Phong
魔神夜魅=Ma Thần Dạ Mị
魔神斩玉=Ma Thần Trảm Ngọc
魔神炎血=Ma Thần Viêm Huyết
魔神炙天=Ma Thần Chích Thiên
鲁道尔夫=Rudolph
鸣萧阁主=Minh Tiêu Các Chủ
麒麟天王=Kỳ Lân Thiên Vương
麦克尔贝=Maikeerbei
麦克罗伊=McRoy
黄泉碧落=Hoàng Tuyền Bích Lạc
黑客帝国=The Matrix
黑暗尊主=Hắc Ám Tôn Chủ
黑暗星空=Hắc Ám Tinh Không
黑暗魔尊=Hắc Ám Ma Tôn
黑暗魔界=Hắc Ám Ma Giới
黑暗魔神=Hắc Ám Ma Thần
黑河鬼王=Hắc Hà Quỷ Vương
黑煞令旗=Hắc Sát Lệnh Kỳ
黑煞剑魂=Hắc Sát Kiếm Hồn
黑煞虎王=Hắc Sát Hổ Vương
黛博奈亚=Basila
龙魔战线=Long Ma Chiến Tuyến
せきな=Sekina
一之濑=Ichino
一页书=Nhất Hiệt Thư
丁世杰=Đinh Thế Kiệt
丁无厚=Đinh Vô Hậu
七剑盟=Thất Kiếm Minh
七情剑=Thất Tình Kiếm
七本木=Shichihongi
七绝阵=Thất Tuyệt Trận
万佛宗=Vạn Phật Tông
万剑诀=Vạn Kiếm Quyết
万秋鸿=Vạn Thu Hồng
万窟山=Vạn Quật Sơn
万萨德=Wansard
三主子=Tam Chủ Tử
三十郎=Sanjuro
三叶草=Clover
三家满=Sanja Furu
三手猿=Tam Thủ Viên
三柱香=Tam Trụ Hương
三绝笔=Tam Tuyệt Bút
三贺本=Sahabi
上官灵=Thượng Quan Linh
上官红=Thượng Quan Hồng
上官虹=Thượng Quan Hồng
上官雄=Thượng Quan Hùng
上官鷹=Thượng Quan Ưng
下龙湾=Vịnh Hạ Long
不列颠=Anh Quốc
不勒斯=Napoli
不夜城=Bất Dạ Thành
不夜天=Bất Dạ Thiên
不越岭=Bất Việt Lĩnh
世界杯=World Cup
丘比特=Cupid
丘洛平=Khâu Lạc Bình
丘蕾蕾=Qulene
东云华=Shinonome Hana
东凡王=Đông Phàm vương
东南亚=Đông Nam Á
东方帅=Đông Phương Suất
东方景=Đông Phương Cảnh
东林国=Đông Lâm quốc
东林王=Đông Lâm vương
东沐云=Đông Mộc Vân
东离尘=Đông Ly Trần
严凌枫=Nghiêm Lăng Phong
严锦飞=Nghiêm Cẩm Phi
严青稔=Nghiêm Thanh Nhẫm
中情局=Cia
中目黑=Meguro
临淄宫=Lâm Truy Cung
丹尼尔=Daniel
丽菲尔=Lifier
久世珣=Kuze Joushun
久鲁瓜=Hishashi
义大利=Italy
乌列尔=Yriel
乌尔克=Urk
乐上师=Nhạc thượng sư
乔乔丽=Jirule
乔凡尼=Giovanni
乔安娜=Joanna
乔杰普=Quixar
乔泠傲=Kiều Linh Ngạo
乔洁普=Quixar
乔追风=Kiều Truy Phong
九九命=Kukunoichi
九九狼=Kukurou
九华山=Cửu Hoa Sơn
九国盟=Cửu Quốc Minh
九绝阵=Cửu Tuyệt Trận
九阴女=Cửu Âm Nữ
九阴洞=Cửu Âm Động
九阴门=Cửu Âm Môn
了圆木=Liễu Viên Mộc
了齐格=Ziege
二之宫=Ninomiya
于文坡=Vu Văn Pha
于长空=Vu Trường Không
云中羽=Vân Trung Vũ
云千化=Vân Thiên Hóa
云天蓝=Vân Thiên Lam
云峰山=Vân Phong Sơn
云澜城=Vân Lan Thành
云镇海=Vân Trấn Hải
云雾峰=Vân Vụ Phong
云霞宫=Vân Hà Cung
五之宫=Gokyuden
五岛润=Goto Ran
五百野=Ihono
五行剑=Ngũ Hành Kiếm
亚伯特=Albert
亚历山=Alexander
亚曼达=Armada
亚特鲁=Yateli
亚遥梅=Adima
亚里亚=Aria
亚里沙=Alisa
亚里莎=Arisa
亚马逊=Amazon
亨德尔=Handel
京命院=Kyomei-in
人间界=Nhân Gian Giới
今子旦=Kyoko-san
今日子=Kyoko
从育科=Khoa Quản gia
仙人谷=Tiên Nhân Cốc
仙剑宗=Tiên Kiếm Tông
仙剑派=Tiên Kiếm Phái
仙剑门=Tiên Kiếm Môn
仙德拉=Alexandra
仙绫宫=Tiên Lăng Cung
仙鸢星=Tiên Diên Tinh
令狐乐=Lệnh Hồ Nhạc
令狐松=Lệnh Hồ Tùng
任雅然=Nhâm Nhã Nhiên
伊利斯=Elise
伊妮丝=Yiily
伊帕萨=Ymatus
伊扎雷=Yzalev
伊拉克=Iraq
伊欧娜=Iona
伊比利=Ibitogi
伊洛恩=Illiad
伊莉斯=Elise
伊莉莎=Elisa
伍德兰=Woodland
伏景轩=Phục Cảnh Hiên
伏特加=Vodka
伏龙谷=Phục Long Cốc
传送阵=Truyện Tống Trận
伦巴第=Lombadia
伯奈利=Beretta
伽尔冈=Garius
伽尔纲=Garius
佐佐木=Sasaki
佐图尔=Zoetus
佐特鲁=Sadeau
佐藤翼=Satou Tsubasa
何君悦=Hà Quân Duyệt
何无彦=Hà Vô Ngạn
何清芳=Hà Thanh Phương
何郁香=Hà Úc Hương
余一平=Dư Nhất Bình
余全海=Dư Toàn Hải
余有路=Dư Hữu Lộ
余梦华=Dư Mộng Hoa
余梦瑶=Dư Mộng Dao
佳也子=Kayako
侏罗纪=Jurassic
依紗子=Yosako
侯赛因=Hussein
侯震撼=Hầu Chấn Hám
俄罗斯=Russia
保时捷=Porsche
修修琳=Lilicia
修布利=Shuburi
修瑞达=Shedira
修真界=Tu Chân Giới
修罗林=Tu La Lâm
候补生=học sinh bổ sung
候越白=Hậu Việt Bạch
倪朵朵=Nghê Đóa Đóa
健次郎=Kenjiro
傅晚晴=Phó Vãn Tình
傑尼斯=Genese
元禧帝=Nguyên Hi Đế
光之丘=Raitohiru
克拉克=Clark
克罗艾=Keith
克莱德=Clyde
克莱昂=Kalas
克郎波=Krona
克里修=Kerruge
克里斯=Chris
克鲁斯=Cruise
八方军=quân Bát Phương
八方城=Bát Phương Thành
八木本=Yagimoto
六合天=Lục Hợp Thiên
六扇门=Lục Phiến Môn
兰多夫=Randolph
兰德尔=Randall
兰普森=Lampson
兰花指=Lan Hoa Chỉ
共和党=Đảng Cộng Hòa
共明日=Soshita
关宏毅=Quan Hoành Nghị
关山月=Quan Sơn Nguyệt
内务府=Nội Vụ Phủ
内惩院=Nội Trừng Viện
冰封坠=Băng Phong Trụy
冰封结=Băng Phong Kết
冰封诀=Băng Phong Quyết
冰山阵=Băng Sơn Trận
冰蝉珠=Băng Thiền Châu
冷凌风=Lãnh Lăng Phong
冷呼儿=Lãnh Hô Nhi
冷家豪=Lãnh Gia Hào
冷晓东=Lãnh Hiểu Đông
冷晶莹=Lãnh Tinh Oánh
冷暮云=Lãnh Mộ Vân
冷残缺=Lãnh Tàn Khuyết
凌云志=Lăng Vân Chí
凌戰天=Lăng Chiến Thiên
凌抱鹤=Lăng Bão Hạc
凌清院=Lăng Thanh Viện
凌空阁=Lăng Không Các
凌笑天=Lăng Tiếu Thiên
凑七海=Minato Nanami
凑千纱=Minato Chisa
凝神丹=Ngưng Thần Đan
凤非烟=Phượng Phi Yên
凤飞烟=Phượng Phi Yên
凯尼斯=Kenneth
凯库斯=Carcas
凯特尔=Keter
刀疤狼=Đao Ba Lang
分神诀=Phân Thần Quyết
分身斩=Phân Thân Trảm
切斯特=Chester
刘世杰=Lưu Thế Kiệt
刘景升=Lưu Cảnh Thăng
刘正贤=Lưu Chính Hiền
利斯拉=Liguel
利格斯=Zeeges
别西卜=Beelzebub
到伊朗=Iran
剑无尘=Kiếm Vô Trần
剑罡宗=Kiếm Cương Tông
加勒比=Caribean
加尔文=Calvin
加尔林=Merligen
加布里=JiaBuli
加扎布=Jamaro
加拿大=Canada
加特林=Gatling
加百列=Gabriel
加迪奥=Gadio
加里乌=Jalair
加鲁特=Juliete
劳伦斯=Lawrence
劳穴光=Lao Huyệt Quang
勾青风=Câu Thanh Phong
化魂池=Hóa Hồn Trì
北堂翼=Bắc Đường Dực
北极星=Polaris
匹可露=Pithia
十杰一=Thập Kiệt Nhất
千 穂=Chiho
千仞峰=Thiên Nhận Phong
千代女=Chiyome
千幻岭=Thiên Huyễn Lĩnh
千影空=Chikage Sora
千德鸡=Sentucky
千翠山=Thiên Thúy Sơn
千鹤子=Chizuko
华天云=Hoa Thiên Vân
华小倩=Hoa Tiểu Thiến
华小曼=Hoa Tiểu Mạn
华小波=Hoa Tiểu Ba
华尔街=Wall Street
华盛顿=Washington
华荐文=Hoa Tiến Văn
华震和=Hoa Chấn Hòa
卓无影=Trác Vô Ảnh
单维正=Đan Duy Chính
南宫垂=Nam Cung Thùy
南宫星=Nam Cung Tinh
南宫望=Nam Cung Vọng
南宫杰=Nam Cung Kiệt
南宫芸=Nam Cung Vân
卡古纳=Talas
卡吉洛=Kaji
卡夫卡=Kafka
卡威司=Kawsi
卡威斯=Kawsi
卡尔基=Karuki
卡尔奥=Kameo
卡尔洛=Gary
卡尔特=Karsen
卡尔隆=Karcon
卡拉克=Karak
卡拉拉=Carrara
卡斯达=Camstar
卡梅伦=Cameron
卡梅隆=Cameron
卡洛斯=Carlos
卡琳娜=Karina
卡米奥=Kameo
卡米拉=Kameo
卡米欧=Kameo
卡莉娜=Karina
卡蒂亚=Kalina
卡迈尔=Camael
卡迪亚=Cartier
卡麦尔=Camael
卢斯安=Luciel
卢梨亚=Luria
卢马克=Lumas
卧龙谷=Ngọa Long Cốc
卫天国=Vệ Thiên Quốc
卫秋娘=Vệ Thu Nương
却亦蘩=Khước Diệc Phiền
厄洛斯=Eros
古斯里=Guthrie
古普达=Gveda
古都子=Kotoko
古雷格=Gugreg
叫赵宏=Khiếu Triệu Hoành
可摩摩=Kemor
可梦伟=Kamui
可露莉=Canele
史丹枫=Sử Đan Phong
史内克=Jelinek
史密斯=Smith
史蒂芬=Steven
史迪芬=Stephen
史黛拉=Seane
右手巴=Uthea
叶天宗=Diệp Thiên Tông
叶天成=Diệp Thiên Thành
叶心仪=Diệp Tâm Nghi
叶方遥=Diệp Phương Diêu
司徒狂=Tư Đồ Cuồng
司徒碧=Tư Đồ Bích
司非情=Tư Phi Tình
司马俟=Tư Mã Sĩ
司马琴=Tư Mã Cầm
司马阳=Tư Mã Dương
司马颙=Tư Mã Ngung
吉利亚=Calista
吉基尔=Jykell
吉尔伯=Gilbert
吉尔拉=Jillete
吉尔默=Gilmer
吉普森=Gibson
同安院=Đồng An Viện
后羿弓=Hậu Nghệ Cung
吕幼文=Lữ Ấu Văn
吕文幼=Lữ Văn Ấu
君不悔=Quân Bất Hối
听禅阁=Thính Thiện Các
启星移=Khải Tinh Di
启示录=Ngày Tận Thế
吴世明=Ngô Thế Minh
吴如耿=Ngô Như Cảnh
吴子溪=Ngô Tử Khê
吴文杰=Ngô Văn Kiệt
周天赐=Chu Thiên Tứ
周婉柔=Chu Uyển Nhu
周思廉=Chu Tư Liêm
周星驰=Châu Tinh Trì
周芷若=Chu Chỉ Nhược
周若梅=Chu Nhược Mai
呱呱命=Kokonoichi
哈乌特=Haurt
哈姆林=Hamrin
哈尔巴=Haerba
哈尤娜=Hajun
哈德利=Hadley
哈格尔=Hágeru
哈瓦纳=Havana
哈迪姆=Khadim
哈鲁德=Halide
哥哥酱=Onii-chan
唐逸云=Đường Dật Vân
唐震天=Đường Chấn Thiên
喀斯特=Karst
善治郎=Zenjiro
嘉利娜=Galia
嘉杰尔=Jaare
嘉睿帝=Gia Duệ Đế
嘉罗斯=Jialuos
嘉蕾邬=Jalair
噬心剑=Phệ Tâm Kiếm
噬心诀=Phệ Tâm Quyết
四主子=Tứ Chủ Tử
四季镜=Shikikagami
回龙镇=Hồi Long Trấn
土之目=Tsuchime
土月族=Thổ Nguyệt Tộc
圣水宫=Thánh Thủy Cung
圣清院=Thánh Thanh Viện
圣经院=Thánh Kinh Viện
地中海=Địa Trung Hải
均恩令=Quân Ân Lệnh
坛茉莉=Jasmine
坤和堂=Khôn Hòa Đường
垃玛斯=Ramus
埃斯卡=Esca
埃斯特=Esther
埃米尔=Armeni
基奴里=Keanu
基尔曼=Kilman
基斯特=Kiest
基诺里=Keanu
堤却尔=Teacher
塔尔巴=Tarren
塞依娜=Seifa
塞克斯=Sussex
塞尔维=Serbia
塞巴夫=Tagran
塞希尔=Cecil
塞莱斯=Seles
塞西尔=Cecil
墓志铭=Epitaph
墨西哥=Mexico
壬生纲=Mibu Gae
夏侯渊=Hạ Hầu Uyên
夏无忧=Hạ Vô Ưu
夏洛瓦=Charlevoix
夏璐蒂=Natsuri
夏达穆=Xidiam
夏龙湾=Vịnh Hạ Long
多亚士=Doyashi
多伦多=Toronto
多哈尔=Dorf
多多良=Tatara
多纳哈=Dohara
多鲁玛=DeLuch
大主子=Đại Chủ Tử
大五郎=Daigoro
大刀王=Đại Đao Vương
大灵儿=Đại Linh Nhi
大砍刀=Đại Khảm Đao
大西洋=Đại Tây Dương
天之都=Thiên Chi Đô
天仙谱=Thiên Tiên Phổ
天佑宫=Thiên Hữu Cung
天剑园=Thiên Kiếm Viên
天剑客=Thiên Kiếm Khách
天剑诀=Thiên Kiếm Quyết
天剑阁=Thiên Kiếm Các
天剑院=Thiên Kiếm Viện
天后铃=Thiên Hậu Linh
天地环=Thiên Địa Hoàn
天壤慈=Tenjoumi
天威令=Thiên Uy Lệnh
天山谷=Thiên Sơn Cốc
天弓院=Tenkuujin
天星客=Thiên Tinh Khách
天星门=Thiên Tinh Môn
天柱峰=Thiên Trụ Phong
天残宗=Thiên Tàn Tông
天水诀=Thiên Thủy Quyết
天池峰=Thiên Trì Phong
天河阵=Thiên Hà Trận
天津饭=Thên Xin Hăng
天湖城=Thiên Hồ Thành
天狼星=Sirius
天玄洞=Thiên Huyền Động
天王塔=Thiên Vương Tháp
天琴阁=Thiên Cầm Các
天益门=Thiên Ích Môn
天禅刀=Thiên Thiền Đao
天穆风=Thiên Mục Phong
天空桥=Tenkuubashi
天草式=Thiên chúa giáo
天蝉刀=Thiên Thiền Đao
天道门=Thiên Đạo Môn
天邪刃=Thiên Tà Nhận
天邪宗=Thiên Tà Tông
天郡星=Thiên Quận Tinh
天都峰=Thiên Đô Phong
太一站=Daichiki
太和楼=Thái Hòa Lâu
太平洋=Thái Bình Dương
太玄山=Thái Huyền Sơn
太玄裂=Thái Huyền Liệt
失刳马=Yakuma(Shikuma)
奇奇努=Kikerc
奈何珠=Nại Hà Châu
奈夫拉=Nafura
奈奈美=Nanami
奈贺村=Shikashi
奉天侯=Phụng Thiên Hầu
奔云剑=Bôn Vân Kiếm
奥丽雅=Alia
奥尔巴=Olba
奥巴阿=Obama
奥拉夫=Ocrawe
奥美加=Omega
奥马哈=Omaha
好莱坞=Hollywood
如意剑=Như Ý Kiếm
妙玉坊=Diệu Ngọc Phường
妮迪丝=Nidisi
姓江的=Tính Giang Đích
姜无崖=Khương Vô Nhai
姜无涯=Khương Vô Nhai
威兹雷=Weonzer
威利斯=Willis
威士忌=Whiskey
威鲁特=Willius
娅丽娅=Aria
娜琦丽=Nakyle
娜莉亚=Dayton
媚珠阁=Mị Châu Các
媞艾拉=Tiana
孔伯端=Khổng Bá Đoan
孔海山=Khổng Hải Sơn
孙不文=Tôn Bất Văn
孙云龙=Tôn Vân Long
孙小蓝=Tôn Tiểu Lam
孙焉然=Tôn Yên Nhiên
孙红梅=Tôn Hồng Mai
孙蔫然=Tôn Yên Nhiên
孟三思=Mạnh Tam Tư
孟姜女=Mạnh Khương Nữ
孟德尔=Menden
孟有威=Mạnh Hữu Uy
孟清漓=Mạnh Thanh Li
孟释青=Mạnh Thích Thanh
宁九微=Trữ Cửu Vi
宁纤雪=Trữ Tiêm Tuyết
宇文坚=Vũ Văn Kiên
宇文灼=Vũ Văn Chước
宇文瑛=Vũ Văn Anh
安东尼=Anthony
安乐侯=An Nhạc Hầu
安妮斯=Aniston
安德列=Andrea
安洁拉=Akyla
安蒂莉=Adery
宋君力=Tống Quân Lực
完颜绪=Hoàn Nhan Tự
宗一郎=Soichiro
定国府=Định Quốc phủ
定国王=Định Quốc Vương
定星珠=Định Tinh Châu
定星阵=Định Tinh Trận
宝时捷=Porsche
宝石捷=Porsche
宝芝林=Bảo Chi Lâm
宫代奏=Miyashiro Kanade
宫太郎=Miyataro
富 沢=Tomizawa
寒冰指=Hàn Băng Chỉ
寒冰珠=Hàn Băng Châu
寒冰盾=Hàn Băng Thuẫn
寒星剑=Hàn Tinh Kiếm
寒玉阳=Hàn Ngọc Dương
寒若华=Hàn Nhược Hoa
寒铁心=Hàn Thiết Tâm
寒镇离=Hàn Trấn Ly
寰宇帝=Hoàn Vũ Đế
封王台=Phong Vương Thai
封神碑=Phong Thần Bi
封魂符=Phong Hồn Phù
将国彬=Tương Quốc Bân
小可汗=Tiểu Khả Hãn
小惠理=Eri-chan
小日族=Tiểu Nhật Tộc
小桂子=Tiểu Quế Tử
小甜甜=Britney
小真冬=Mafuyu-chan
小绯影=Hisaki-san
小舞儿=Tiểu Vũ Nhi
小艾米=Emi-chan
小葵花=Tiểu Quỳ Hoa
小都里=Kodearu
小野寺=Onodera
小饼子=Tiểu Bính Tử
小龙女=Tiểu Long Nữ
尤利安=Julian
尤卡穆=Nkamus
尤菲娜=Elfia
尤鲁库=Vulgen
尼古拉=Nicola
尼多廉=Nidlo
尼米兹=Nimitz
展群傲=Triển Quần Ngạo
屠龙棍=Đồ Long Côn
屠龙门=Đồ Long Môn
山水居=Sơn Thủy Cư
山鹿镇=Sơn Lộc Trấn
岛魔姬=Damasus
岬沙树=Misaki Saki
崔小玄=Thôi Tiểu Huyền
崔百睢=Thôi Bách Tuy
崔采婷=Thôi Thải Đình
嵯峨良=Sagara
左乙女=Saotome
巨龙剑=Cự Long Kiếm
巴克尔=Barker
巴塞尔=Baselle
巴尔特=Barthos
巴拉贡=Bapratt
巴纳尔=Bader
巴里奥=Barro
巴里恩=Balier
巴雷特=Barrett
巴鲁克=Baruch
布拉格=Prague
布皮特=Brad Pitt
布莱妮=Spears
布莱安=Bryan
布莱特=Bratt
布鲁图=Brutus
布鲁斯=Bruce
希尔曼=Shearman
希尔顿=Hilton
希达尔=Kildale
希露娜=Yluna
希露菲=Xirene
帕德森=Pade Sen
帕里斯=Paris
帝朗司=Đế Lãng Ti
常五德=Thường Ngũ Đức
常得富=Thường Đắc Phú
幕缭菱=Mạc Liễu Lăng
平南王=Bình Nam Vương
平和岛=Heiwajima
幽灵王=U Linh Vương
幽灵间=U Linh Gian
庄元卜=Trang Nguyên Bặc
库哈诺=Kohnack
库夏尔=Kzart
库尔姆=Khurles
库拉拉=Kurara
库沃克=Kukra
库瓦雷=Kwaara
库阿德=Kruel
应崇优=Ứng Sùng Ưu
庞多哈=Pandhor
庞托纳=Pargina
庶民部=Commoner Club
康莱德=Calius
开天斧=Khai Thiên Phu
开封府=Khai Phong Phủ
弄潮儿=Lộng Triều Nhi
引灵诀=Dẫn Linh Quyết
弗兰德=Flanders
弗里达=Frieda
弗雷姆=Fremr
张傲雪=Trương Ngạo Tuyết
张剑成=Trương Kiếm Thành
张向风=Trương Hướng Phong
张天华=Trương Thiên Hoa
张宏轩=Trương Hoành Hiên
张尽崖=Trương Tẫn Nhai
张立强=Trương Lập Cường
张耀川=Trương Diệu Xuyên
张阗宝=Trương Điền Bảo
弥休斯=Hughes
弦学姐=Chizuru-sempai
归元诀=Quy Nguyên Quyết
归凤山=Quy Phượng Sơn
影舞者=Arathon
徐芷晴=Từ Chỉ Tình
御剑诀=Ngự Kiếm Quyết
御龙令=Ngự Long Lệnh
微微安=Vi Vi An
德哈鲁=Dorf
德布斯=Debs
德库拉=Dracula
德鲁夫=Descur
心乃枝=Kokonoe
志志谷=Kokozashi
忘忧谷=Vong Ưu Cốc
怒蛟島=Nộ Giao Đảo
怒蛟幫=Nộ Giao Bang
恐怖子=Kyofuko
恩克港=Encke
恩斯特=Ernst
恩蒂斯=Entis
恭一郎=Kyoichiro
恭太郎=Kyoutaro
息红泪=Tức Hồng Lệ
惊神弓=Kinh Thần Cung
意大利=Italy
慈航轩=Từ Hàng Hiên
慕容俊=Mộ Dung Tuấn
慕容惟=Mộ Dung Duy
慕容棋=Mộ Dung Kỳ
慕容炜=Mộ Dung Vĩ
慕容静=Mộ Dung Tĩnh
戈道格=Jacobi
戊星卫=Mậu Tinh Vệ
成宫亮=Thành Cung Lượng
战天斧=Chiến Thiên Phủ
戚少商=Thích Thiếu Thương
戚无忧=Thích Vô Ưu
戴拉夫=Dumus
房海蓉=Phòng Hải Dong
所罗门=Solomon
扎马多=Tarmahat
托尔克=Tolke
托尼欧=Tornio
托托娜=Sisira
托雷斯=Kalis
扭洛莉=Noctrine
抱佛脚=cuống lên mới lo ôm chân Phật
拉乌尔=Raoul
拉姆斯=Ramus
拉拉克=Lapare
拉拉雅=Lalaya
拉提娜=Latina
拉斐尔=Rafael
拉朵因=Lapranin
拉枪栓=Latin
拉泰德=LaTade
拉潘德=Laprost
拉玛斯=Ramus
拉穆奇=La Muqi
拉缇娜=Latina
拉贵尔=Raguel
拉达克=Ladakh
拜斯廷=Justin
拿破仑=Napoleon
提亚哥=Tiago
提斯洛=Diretar
摄制王=Nhiếp Chính Vương
摩斯拉=Mothra
擎天剑=Kình Thiên Kiếm
收魂术=Thu Hồn Thuật
敷华殿=Phu Hoa Điện
文不与=Văn Bất Dữ
文不名=Văn Bất Danh
文天赐=Văn Thiên Tứ
文牧枫=Văn Mục Phong
斩天诀=Trảm Thiên Quyết
斩风剑=Trảm Phong Kiếm
断续膏=Đoạn Tục Cao
斯卡特=Skarte
斯大林=Stalin
斯巴达=Sparta
斯拉姆=Slam
斯洛坞=Silock
斯蒂芬=Steven
新横滨=Shiyokohama
新稻叶=Shininaba
方亦神=Phương Diệc Thần
方八指=Phương Bát Chỉ
方八爷=Phương Bát Gia
方剑明=Phương Kiếm Minh
方君乾=Phương Quân Càn
方大海=Phương Đại Hải
方家慧=Phương Hoa Tuệ
方应看=Phương Ứng Khán
方格斯=Farage
方滢滢=Phương Huỳnh Huỳnh
方简惠=Phương Giản Huệ
施密特=Schmitt
施小兽=Thi Tiểu Thú
旋风斧=Toàn Phong Phu
无为道=Vô Vi Đạo
无人座=Vô Nhân Tọa
无极宗=Vô Cực Tông
无极门=Vô Cực Môn
无泪城=Vô Lệ Thành
无赦谷=Vô Xá Cốc
无魂间=Vô Hồn Gian
日伊奈=Hiina
日高见=Hitakami
旧金山=San Francisco
早乙女=Saotome
早少女=Saotome
早百合=Sayuri
时冢晶=Otsuka Kessho Toki
昆德拉=Kundera
明日哥=Asuta-nii
明日太=Asuta
明月峰=Minh Nguyệt Phong
明月楼=Minh Nguyệt Lâu
易天阁=Dịch Thiên Các
易明慧=Dịch Minh Tuệ
易轻语=Dịch Khinh Ngữ
易连城=Dịch Liên Thành
星光剑=Tinh Quang Kiếm
星辰变=Tinh Thần Biến
映月坞=Ánh Nguyệt Ổ
春公公=Xuân Công Công
是吉格=Gigeris
普乔尔=Proteus
普拉达=Prada
普里斯=Philip
曲奇饼=bánh Cookie
曲飞扬=Khúc Phi Dương
曹供奉=Tào Cung Phụng
曹天佑=Tào Thiên Hữu
曼哈顿=Manhattan
月华殿=Nguyệt Hoa Điện
月夜子=Tsukiyoko
月牙儿=Nguyệt Nha Nhi
月神殿=Nguyệt Thần Điện
月露坊=Nguyệt Lộ Phường
有栖川=Arisugawa
朝雾怜=Asagiri Rei
朧月夜=Oborodzukiyo
木志郎=Kishiro
木陰野=Kokago
未央宫=Vị Ương Cung
未灵风=Vị Linh Phong
末摘花=Suetsumuhana
本田樱=Honda Sakura
朱丹霁=Chu Đan Tễ
朱丽亚=Julia
朱丽叶=Juliet
朱利奥=Julio
朱祁嫣=Chu Kỳ Yên
朱祁钰=Chu Kỳ Ngọc
朱祁镇=Chu Kỳ Trấn
朱笑白=Chu Tiếu Bạch
朱芷清=Chu Chỉ Thanh
朱芷贞=Chu Chỉ Trinh
杉崎键=Sugisaki Ken
李三思=Lí Tam Tư
李云龙=Lý Vân Long
李北斗=Lý Bắc Đẩu
李圣基=Li Shengji
李宏飞=Lý Hoành Phi
李察尔=Lysander
李小龙=Lí Tiểu Long
李尘埃=Lý Trần Ai
李岳凡=Lý Nhạc Phàm
李幸学=Lý Hạnh Học
李文景=Lí Văn Cảnh
李斯特=Listeria
李梦棠=Lý Mộng Đường
李清愁=Lý Thanh Sầu
李生虎=Lý Sinh Hổ
李英杰=Lý Anh Kiệt
李连杰=Lí Liên Kiệt
李长春=Lý Trường Xuân
李长河=Lý Trường Hà
李雷云=Lý Lôi Vân
杜伯曼=Doberman
杜兰朵=Durandal
杜兰达=Durandal
杜加里=Dougal
杜拉罕=Dullahan
杜百英=Đỗ Bách Anh
杨不悔=Dương Bất Hối
杨小波=Dương Tiểu Ba
杨柳月=Dương Liễu Nguyệt
杨逐宇=Dương Trục Vũ
杨风铃=Dương Phong Linh
杨馨儿=Dương Hinh Nhi
杰伊德=Jaefer
杰米斯=Demis
杰莱德=Kelene
杰西卡=Jessica
林世荣=Lâm Thế Vinh
林云枫=Lâm Vân Phong
林云风=Lâm Vân Phong
林依依=Lâm Y Y
林惟天=Lâm Duy Thiên
林文正=Lâm Văn Chính
林晚荣=Lâm Vãn Vinh
林果酱=Furutsu
林淡之=Lâm Đạm Chi
林馨儿=Lâm Hinh Nhân
林默言=Lâm Mặc Ngôn
枢密院=Xu Mật Viện
枪葱兰=Zephyrante
查哈德=Jhad
查赛德=Chesed
柯克马=Chokhmah
柯媚蒂=Karmadi
柯尔纳=Keefa
柯汉郡=quận Kha Hán
柯洛特=Kaluet
柳二龙=Liễu Nhị Long
柳堰旭=Liễu Yển Húc
柳天华=Liễu Thiên Hoa
柳无双=Liễu Vô Song
柳星魂=Liễu Tinh Hồn
柳残红=Liễu Tàn Hồng
栗花落=Tsuzuri
格兰特=Grant
格尔德=Geroth
格拉夫=Gerald
格拉索=Grasso
格格巫=Google Vu
格莱泰=Gretei
格里哥=Gregor
格鲁姆=Groom
桃花坞=Đào Hoa Am
桑特雷=Sitale
梅丽亚=Maria
梅丽特=Mei Lite
梅丽莎=Malisa
梅尔特=Meler
梅普尔=Maple
梅杜莎=Medusa
梅洛尔=Mastarc
梅涅娅=Menea
梅莉萨=Magarsa
梅里沙=Malisa
梅里莎=Malisa
梅露乌=Meroo
梅鲁托=Meler
梦工厂=Dreamworks
楚天英=Sở Thiên Anh
楚天雄=Sở Thiên Hùng
楚御九=Sở Ngự Cửu
楚怀之=Sở Hoài Chi
楚怀阳=Sở Hoài Dương
楚江龙=Sở Giang Long
楚浩飞=Sở Hạo Phi
槌之子=Tsuchinoko(yêu quái)
欢颜草=Hoan Nhan Thảo
欧利恩=Orion
欧尼尔=O'neil
欧拉莎=Olasha
欧莱尔=O'Larry
欧蒂娜=Utena
欧里奥=Orion
欧阳涛=Âu Dương Đào
欧鲁托=Ograt
正律院=Chánh Luật Viện
死定云=Tử Định Vân
死魂间=Tử Hồn Gian
残神庙=Tàn Thần Miếu
残神诀=Tàn Thần Quyết
残阳子=Tàn Dương Tử
段克邪=Đoạn Khắc Tà
段淳风=Đoạn Thuần Phong
殷天正=Ân Thiên Chính
殷红袖=Ân Hồng Tụ
殷若澈=Ân Nhược Triệt
殷野王=Ân Dã Vương
毁诺城=Hủy Nặc Thành
比佛利=Beverly
比利亚=Liberia
比利山=Billy Hill
比华利=Beverly
比基尼=Bikini
比奥提=Aoti
比昂斯=Beyonce
毛主席=Mao Chủ Tịch
民主党=Đảng Dân Chủ
气天王=Khí Thiên Vương
水晶门=Thủy Tinh Môn
水灵术=Thủy Linh Thuật
水芙蓉=Thủy Phù Dung
水麒麟=Thủy Kỳ Lân
永福町=Eifucho flat
汀布拉=Tinbura
汉塞尔=Hansel
江天九=Giang Thiên Cửu
江砥平=Giang Chỉ Bình
汪达雷=Wanderlei
沈心瑶=Trầm Tâm Dao
沈清悒=Trầm Thanh Ấp
沈玉清=Trầm Ngọc Thanh
沈红英=Trầm Hồng Anh
沈舟虛=Trầm Chu Hư
沈边儿=Trầm Biên Nhi
沉风剑=Trầm Phong Kiếm
沐颖然=Mộc Dĩnh Nhiên
沙利叶=Sariel
沙哈拉=Sahara
沙姆斯=Samus
沙维尔=Xavier
沙罗野=Sayara
治五郎=Jigoro
法德拉=Pharissa
法拉利=Ferrari
法比奥=Fabio
法蒂玛=Fatima
法诺瓦=Fanoran
泗水关=Tứ Thủy quan
波利尔=Montpeller
波多希=Bodquar
波拉特=Borat
波比诺=Abino
泣血魔=Khấp Huyết Ma
泰坦尼=Titanic
洗髓经=Tẩy Tủy Kinh
洛伊德=Roid
洛基苏=Luo Jisu
洛塔斯=Luxtart
洛家封=Lạc Gia Phong
洛山矶=Los Angeles
洛德鲁=Roth
洛杉矶=Los Angeles
洛止寒=Lạc Chỉ Hàn
洛水国=Lạc Thủy Quốc
派拉蒙=Paramount
流 玥=Lưu Nguyệt
流星泪=Lưu Tinh Lệ
流花喵=Rukanya
浩天府=Hạo Thiên Phu
浪翻云=Lãng Phiên Vân
海公公=Hải Công Công
海兹尔=Halzier
海凤凰=Hải Phượng Hoàng
海德拉=Hydra
海心山=Hải Tâm Sơn
海莉娜=Halia
涅飞尔=Griefel
淡月痕=Đạm Nguyệt Ngân
清云丹=Thanh Vân Đan
清虚期=Thanh Hư Kỳ
清逸阁=Thanh Dật Các
清风阁=Thanh Phong Các
渡良濑=Watarase
温哥华=Vancouver
游天龙=Du Thiên Long
湛飞阳=Trạm Phi Dương
源一郎=Genichiro
源理镇=Nguyên Lý Trấn
满春园=Mãn Xuân Viên
潘俊伟=Phan Tuấn Vĩ
潘多拉=Pandora
潘美美=Phan Mỹ Mỹ
火云石=Hỏa Vân Thạch
火灵儿=Hỏa Linh Nhi
灭天诀=Diệt Thiên Quyết
灭神剑=Diệt Thần Kiếm
灭神殿=Diệt Thần Điện
灭魂刀=Diệt Hồn Đao
灯一朗=Akachiro
炫极宗=Huyễn Cực Tông
炫紫殿=Huyễn Tử Điện
炮打灯=Pháo Đả Đăng
炼心殿=Luyện Tâm Điện
炼魂鼎=Luyện Hồn Đỉnh
烈中流=Liệt Trung Lưu
烈中石=Liệt Trung Thạch
烈火宫=Liệt Hỏa Cung
烈焰斩=Liệt Diễm Trảm
烏爾剛=Worgang
烟浮宫=Yên Phù Cung
烟雨楼=Yên Vũ Lâu
焚星宗=Phần Tinh Tông
焚星火=Phần Tinh Hỏa
焚星轮=Phần Tinh Luân
焚阴宗=Phần Âm Tông
熊五郎=Kumagoro
燕秋水=Yến Thu Thủy
燕飞凤=Yến Phi Phượng
爱丽丝=Alice
爱丽儿=Ariel
爱丽娜=Elena
爱丽榭=Elise
爱尔兰=Ireland
爱尔斯=Aeryl
爱德华=Etuva
爱莉丝=Alice
爱莉娜=Elena
牧星寒=Mục Tinh Hàn
特伦托=Trento
特劳斯=Strauss
特洛伊=Troy
特蕾莎=Theressa
犬饲洁=Inukai Suguru
狂沙星=Cuồng Sa Tinh
狄向秋=Địch Hướng Thu
独孤明=Độc Cô Minh
狮王盾=Sư Vương Thuẫn
猪之头=Buta Heddo
玄光镜=Huyền Quang Kính
玄冰天=Huyền Băng Thiên
玄冰诀=Huyền Băng Quyết
玄冰髓=Huyền Băng Tủy
玄剑堂=Huyền Kiếm Đường
玄天剑=Huyền Thiên Kiếm
玄天鉴=Huyền Thiên Giám
玄武帝=Huyền Vũ Đế
玄沐羽=Huyền Mộc Vũ
玄阴女=Huyền Âm Nữ
玄阴门=Huyền Âm Môn
玄风门=Huyền Phong Môn
玉兰节=Magnolia Festival
玉无双=Ngọc Vô Song
玉无尘=Ngọc Vô Trần
玉无暇=Ngọc Vô Hạ
玉无缺=Ngọc Vô Khuyết
玉玲珑=Ngọc Linh Lung
玉萧生=Ngọc Tiêu Sinh
玉龙山=Ngọc Long Sơn
王伏虎=Vương Phục Hổ
王保儿=Vương Bảo Nhi
王国军=Vương Quốc Quân
王学峰=Vương Học Phong
王权兵=Vương Quyền Binh
玖璃梦=Kurimu
玛古纳=Magna
玛尤娜=Majun
玛尼斯=Mani
玛德琳=Madeleine
玛戈塔=Magenta
玛格纳=Magna
玛格那=Magna
玛菲斯=Mafaya
玲珑塔=Linh Lung Tháp
琉叶郡=Lưu Diệp quận
琉璃国=Lưu Ly Quốc
琉璃宫=Lưu Ly Cung
瑟克特=Serker
瑟妮亚=Sernia
瑟妮娅=Senia
瑟尼亚=Senia
瑟拉芬=Seraphim
瑠 璃=Ruri
瑪莉亞=Maria
瑶山村=Dao Sơn Thôn
甘多夫=Gan Dalf
甘比诺=Gambino
生死间=Sinh Tử Gian
生魂间=Sinh Hồn Gian
田之上=Tanoue
田承嗣=Điền Thừa Tự
田胜宇=Điền Thắng Vũ
甲阳园=Danseien
疾风殿=Tật Phong Điện
疾风顶=Tật Phong Đỉnh
白丽陵=Hakureiryou
白云天=Bạch Vân Thiên
白云飞=Bạch Vân Phi
白依怡=Bạch Y Di
白如霜=Bạch Như Sương
白延临=Bạch Diên Lâm
白延斌=Bạch Diên Bân
白狼佐=Byakura
白玉堂=Bạch Ngọc Đường
白虎帮=Bạch Hổ Bang
白长松=Bạch Trường Tùng
百晓生=Bách Hiểu Sanh
百花谱=Bách Hoa Phổ
百花门=Bách Hoa Môn
的多拉=Dedra
皇甫傲=Hoàng Phủ Ngạo
皇龙骆=Hoàng Long Lạc
皮埃尔=Pierre
皮尔森=Pearson
皮耶德=Lizha
盖尔德=Gelder
盖碧拉=Gevurah
相一郎=Souichi
相国寺=Tướng Quốc Tự
相川步=Aikawa Ayumu
看唱本=Khán Xướng Bổn
真木野=Makino
真梨花=Marika
真理亚=Majia
真真子=Mamako
真知子=Machiko
真魔功=chân ma công
瞳剑悯=Đồng Kiếm Mẫn
瞳将军=Đồng tướng quân
瞳少爷=Đồng thiếu gia
矢刳马=Yakuma
石杷实=Jitsuwa
破神枪=Phá Thần Thương
碎云渊=Toái Vân Uyên
碧水湖=Bích Thủy Hồ
碧落剑=Bích Lạc Kiếm
碧蓝宫=Bích Lam Cung
磐涅期=Bàn Niết Kỳ
磨璃亚=Malia
祝红瘦=Chúc Hồng Sấu
神乐坂=Kagurazaka
神兵谱=Thần Binh Phổ
神座木=Kanzaku
神目堂=Thần Mục Đường
神谕院=Thần Dụ Viện
神龛门=Thần Kham Môn
福布斯=Forbes
福斯泰=Paula
福特鸥=Forgull
福雷德=Fred
离 宫=Ly Cung
秋先生=Mr Michael
秋叶原=Akihabara
秋婉璃=Thu Uyển Ly
秋山忍=Akiyama Shinobu
秋若水=Thu Nhược Thủy
科林法=Colin
科西嘉=Corsica
秦仙儿=Tần Tiên Nhi
秦心英=Tần Tâm Anh
秦振扬=Tần Chấn Dương
移天尺=Di Thiên Xích
秽杀刃=Foul Slayer
程久孺=Trình Cửu Nhũ
程兆琦=Trình Triệu Kỳ
程振全=Trình Chấn Toàn
程水若=Trình Thủy Nhược
穆内斯=Martinez
穆鸠平=Mục Cưu Bình
空灵鸟=Không Linh Điểu
立长河=Lập Trường Hà
童五洲=Đồng Ngũ Châu
童天仇=Đồng Thiên Cừu
笹 冢=Sasazuka
笹 塚=Sasazuka dorm
等离子=Plasma
箱子燕=Tương Tử Yến
米加尔=Miganer
米尼翁=Minion
米歇尔=Michelle
米米亞=Mimia
米诺拉=Minulac
米迦勒=Michael
米迦尔=Miganer
米高梅=Metro-Gold
索伦娜=Soluna
索妮亚=Sonia
索希葉=Solie
索蕾娜=Talea
索露娜=Taluna
索非亚=Sofia
紫影剑=Tử Ảnh Kiếm
紫织子=Shioriko
紫薇院=Tử Vi Viện
紫铖兜=Túi Tử Thành
繁星仪=Phồn Tinh Nghi
约翰斯=Johann
纪小黑=Kỷ Tiểu Hắc
纪芙蓉=Kỷ Phù Dung
纱碧奈=Sabina
纳兰丹=Nạp Lan Đan
纳兰星=Nạp Lan Tinh
纳兰风=Nạp Lan Phong
纳扎克=Netzach
纳桀尔=Nagare
细雨中=Tế Vũ Trung
终结者=Terminator
绘梨花=Hirika
绝仙阵=Tuyệt Tiên Trận
绝天阵=Tuyệt Thiên Trận
绝尘剑=Tuyệt Trần Kiếm
绝生剑=Tuyệt Sanh Kiếm
绝阴谷=Tuyệt Âm Cốc
绯夜梨=Hiyorunashi
维亚利=Viary
维克司=Duy Khắc Tư
维克多=Victor
维克斯=Vicker
维尔五=Neville
维尔菲=Neville
维纳斯=Venus
维雅莉=Uxina
绿 银=Lục Ngân
缥缈峰=Phiếu Miểu Phong
罗伊兹=Layus
罗伯特=Robert
罗兰度=Rolandio
罗哈特=Rohard
罗密欧=Romeo
罗德斯=Rhodes
罗明威=La Minh Uy
罗洁娜=Razia
罗生门=Rashomon
罗米欧=Romeo
罗莉塔=Lolita
罗蕾雅=LaLemar
罗贯中=La Quán Trung
罗马尔=Luam
美千绪=Misenito
美和尚=Mỹ Hòa Thượng
美奈子=Minako
美智留=Michiru
美杜莎=Medusa
美洲虎=Jaguar
美由纪=Miyuki
美美奈=Mimina
美英子=Mieko
美迦洛=Megalo
群花谱=Quần Hoa Phổ
群芳谱=Quần Phương Phổ
羽亲王=Vũ Thân Vương
翠红楼=Thúy Hồng Lâu
翠里子=Tsuiyuriko
翰戴普=John Depp
老友记=Friends
而加布=Jia Buli
耶索德=Yesod
聂斯特=Dniester
聂皇杰=Niếp Hoàng Kiệt
聪一郎=Gouchiro
肖倾宇=Tiếu Khuynh Vũ
肖公子=Tiếu Công tử
肖青璇=Tiếu Thanh Tuyền
肖青轩=Tiếu Thanh Hiên
肯奔驰=Mercedes-Benz
肯尼斯=Kenneth
肯特基=Kentucky
胡不归=Hồ Bất Quy
胡宇恒=Hồ Vũ Hằng
胡怨青=Hồ Oán Thanh
胡月儿=Hồ Nguyệt Nhi
胭脂湖=Yên Chi Hồ
舒特珑=Strom
舞阳剑=Vũ Dương Kiếm
色天王=Sắc Thiên Vương
艾丽娅=Ailiya
艾丽娜=Elena
艾丽斯=Alice
艾丽泽=Elise
艾丽莎=Eliza
艾伯特=Albert
艾契斯=Amis
艾尔利=Aelie
艾尔夫=Aefer
艾尔莉=Aelie
艾德尔=Elder
艾德路=Elder
艾德露=Adler
艾拉尔=Ellanor
艾特瓦=Etuva
艾米尔=Armeni
艾莉丝=Alice
艾莉娜=Elena
艾莉安=Ellysia
艾莱娜=Alina
艾蕾因=Allerin
艾蕾娜=Alina
艾蕾欧=Elena
艾谢尔=Alciel
艾露洛=Arrales
艾鲁德=Luder
艾黎可=Yili
芙拉乌=Fuwel
芙莉达=Frieda
芭妮莎=Banisha
花自流=Hoa Tự Lưu
花香芸=Hoa Hương Vân
苍龙谷=Thương Long Cốc
苍龙门=Thương Long Môn
苏星浪=Tô Tinh Lãng
苏格兰=Scotland
苏联的=Soviet
苏菲菲=Tô Phỉ Phỉ
茂杰郡=quận Mậu Kiệt
范一飞=Phạm Nhất Phi
范婉华=Phạm Uyển Hoa
茱丽叶=Juliet
药圣阁=Dược Thánh Các
莉 瑅=Reiki
莉莉欧=Lilie
莉菲尔=Lifier
莫东海=Mạc Đông Hải
莫妮卡=Monica
莫幸禅=Mạc Hạnh Thiện
莫德林=Modlin
莫言笑=Mạc Ngôn Tiếu
莫雨燕=Mạc Vũ Yến
莫雷诺=Moreno
莱伊顿=Layton
莱奥尔=Laius
莱弗尔=Lafuer
莱柏特=Laberd
莱欧尔=Laius
菩提院=Bồ Đề Viện
菲丽娅=Felya
菲利普=Philip
菲力浦=Philips
菲哥顿=Benary
菲尔娜=Felina
菲尔德=Ferderer
菲尔特=Fhuss
菲律宾=Philippines
萧日晴=Tiêu Nhật Tình
萧玉若=Tiêu Ngọc Nhược
萧玉霜=Tiêu Ngọc Sương
萧若星=Tiêu Nhược Tinh
萨列里=Salieri
萨娜蕾=Salina
萨尔木=Tát Nhĩ Mộc
萨弗里=Savery
萨德勒=Sadler
萨朗耶=Tát Lãng Gia
萨莉亚=Saizeriya
萨里克=Gizarick
萨雷娜=Salina
萨马多=Samard
萩蕾蕾=Qulene
葡萄牙=Bồ Đào Nha
董巧巧=Đổng Xảo Xảo
董雪卿=Đổng Tuyết Khanh
董青山=Đổng Thanh Sơn
蒂罗尔=Tirol
蒲星辉=Bồ Tinh Huy
蓝德尔=Ladier
蕾西亚=Latia
薛紅線=Tiết Hồng Tuyến
藏尸江=Tàng Thi Giang
藤卷萤=Fujimaki Hotaru
蘇放豪=Tô Phóng Hào
虚无界=Hư Vô Giới
蚀骨龙=Thực Cốt Long
蜘蛛侠=Spider Man
蜜蓄儿=Millie
蜜蕾儿=Millie
蜜雷儿=Millie
蝎子王=Hạt Tử Vương
蝙蝠侠=Batman
血光斩=Huyết Quang Trảm
血公子=Huyết Công Tử
血手门=Huyết Thủ Môn
血河图=Huyết Hà Đồ
血灵鸟=Huyết Linh Điểu
血魂爪=Huyết Hồn Trảo
衫崎健=Sugisaki
袁清河=Viên Thanh Hà
袖招阁=Tụ Chiêu Các
裂天剑=Liệt Thiên Kiếm
西尔芙=Shiku
西西里=Sicilian
詹妮弗=Jennifer
詹姆斯=James
计千愁=Kế Thiên Sầu
许德拉=Hydra
许文河=Hứa Văn Hà
许沧海=Hứa Thương Hải
许青衣=Hứa Thanh Y
设玄女=Thiết Huyền Nữ
诛魔剑=Tru Ma Kiếm
诛魔院=Tru Ma Viện
诸葛亮=Gia Cát Lượng
诹访部=Suwabe
诹访间=Suwama
诺尔德=Nord
诺曼底=Normandy
诺琪亚=Noah
诺琪雅=Noah
诺瓦尔=Noli
诺艾尔=Noeli
诺艾露=Nol
诺迪斯=Nderska
诺里斯=Norris
谭子期=Đàm Tử Kỳ
谷清风=Cốc Thanh Phong
谷若虚=Cốc Nhược Hư
谷风之=Cốc Phong Chi
谷飞鸿=Cốc Phi Hồng
贝尔顿=Belton
贝欧尼=Beyni
贝露努=Belune
财天王=Tài Thiên Vương
费露娜=Frean
贺全福=Hạ Toàn Phúc
贾伊德=Jia Yide
贾克柏=Jacob
贾孟齐=Cổ Mạnh Tề
贾目奇=Cổ Mục Kì
赏心斋=Thưởng Tâm Trai
赛勒丝=Saris
赛席欧=Tarion
赛斯勒=Dressler
赛李逵=Tái Lý Quỳ
赛梅尔=Semel
赛欧娜=Saofern
赛科特=Daslc
赛达姆=Saddam
赤炼教=Xích Luyện Giáo
赤血剑=Xích Huyết Kiếm
赤阳剑=Xích Dương Kiếm
赫凯特=Hecker
赫蒂耶=Hedia
赫连决=Hách Liên Quyết
赫连渝=Hách Liên Du
赫连瑜=Hách Liên Du
赫鲁索=Heclur
赵三胜=Triệu Tam Thắng
赵云兴=Triệu Vân Hưng
赵有志=Triệu Hữu Chí
赵未明=Triệu Vị Minh
赵言云=Triệu Ngôn Vân
越南盾=Việt Nam Đồng
越振宣=Việt Chấn Tuyên
越王剑=Việt Vương Kiếm
路亚飞=Lộ Á Phi
路易丝=Louise
路易斯=Lewis
路莫古=Lothric
路菲克=Lofick
路西法=Lucifer
轩以承=Hiên Dĩ Thừa
轩辕月=Hiên Viên Nguyệt
轩辕静=Hiên Viên Tĩnh
轰慎吾=Torodoki Shingo
辛德勒=Schindler
边青衡=Biên Thanh Hành
达利尔=Daryle
达利路=Daliser
达狭斯=Dasari
达芬奇=Da Vinci
达西美=Joga
迈克尔=Michael
迈卢特=Meler
连云寨=Liên Vân Trại
连爷爷=Liên Gia Gia
连环阵=Liên Hoàn Trận
迪奥鲁=Dracle
迪尼恩=Tenion
迪莉娅=Delia
迪雁特=Dicarte
迪马斯=Dimar
追魂刀=Truy Hồn Đao
逆水寒=Nghịch Thủy Hàn
通天图=Thông Thiên Đồ
通灵鸟=Thông Linh Điểu
逝水流=Thệ Thủy Lưu
速星轮=Tốc Tinh Luân
逸仙楼=Dật Tiên Lâu
達穆爾=Damour
遮罗耶=Già La Da
那巴拉=Nashorn
那由多=Nayuta
邬穆尔=Womer
郁金香=Tulip
郑可庄=Trịnh Khả Trang
郑志铎=Trịnh Chí Đạc
郑清风=Trịnh Thanh Phong
郝文真=Hác Văn Chân
郭巧丽=Quách Xảo Lệ
郭无常=Quách Vô Thường
酒天王=Tửu Thiên Vương
酒肉僧=Tửu Nhục Tăng
醉春楼=Túy Xuân Lâu
醍醐丝=Thể Hồ Ti
醒神经=Tỉnh Thần Kinh
里亚拉=Liyala
里风云=Lý Phong Vân
野魂林=Dã Hồn Lâm
金三角=Tam Giác Vàng
金凯瑞=Jim Carrey
金斐陵=Kim Phỉ Lăng
金田一=Kindaichi
金辽王=Kim Liêu Vương
钟子丹=Chung Tử Đan
钟情妮=Chung Tình Ny
钟泽豪=Chung Trạch Hào
钱不修=Tiễn Bất Tu
铁普塔=Igura
铁桶阵=Thiết Dũng Trận
铁砂掌=Thiết Sa Chưởng
银次郎=Ginjiro
银舍利=Ginshi
锁锁美=Kakami
锁魂井=Tỏa Hồn Tỉnh
镇魂符=Trấn Hồn Phù
长乐宫=Trường Nhạc Cung
长春堂=Trường Xuân Đường
长生瓶=Trường Sanh Bình
闹江蛟=Nháo Giang Giao
闻人旭=Văn Nhân Húc
阎王令=Diêm Vương Lệnh
阴尸江=Âm Thi Giang
阴尸间=Âm Thi Gian
阴玄生=Âm Huyền Sanh
阴魂林=Âm Hồn Lâm
阿修雷=Hughes
阿克拉=Accra
阿凯亚=Akran
阿妮塔=Anita
阿尔卑=Alpine
阿尔娜=Anina
阿尔法=Alpha
阿尔芭=Alba
阿弗兰=Quran
阿拉丝=Alas
阿拉伯=Ảrập
阿拉德=Adrah
阿拉斯=Alas
阿拉贡=Aragon
阿拔斯=Abbas
阿斯兰=Aslan
阿斯摩=Asura
阿曼江=sông A Mạn
阿曼达=Amanda
阿汤哥=Tom Cruise
阿波罗=Apollo
阿洛玛=Lumia
阿玛尼=Armani
阿瑞斯=Ares
阿穆特=Amute
阿莱斯=Ales
阿诺德=Arnold
阿里德=Alid
阿里扎=Alizha
阿里林=Ariran
阿难剑=A Nan Kiếm
阿露特=Lune
阿鲁斯=Ars
阿齐滋=Al-Zi
陆中平=Lục Trung Bình
陆吉亚=Luugea
陆奥田=Ryokuda
陆蒙山=Lục Mông Sơn
陈世东=Trần Thế Đông
陈太医=Trần thái y
陈玉鸾=Trần Ngọc Loan
陈琛旭=Trần Sâm Húc
陈锦蓝=Trần Cẩm Lam
降魔殿=Hàng Ma Điện
降魔组=Hàng Ma Tổ
陶东成=Đào Đông Thành
陶洛斯=Talosi
隆巴顿=Long Button
隐光剑=Ẩn Quang Kiếm
雁飞凤=Nhạn Phi Phượng
雅典娜=Athena
雅尔塔=Yalta
雅莉亚=Maria
雅蠛蝶=Yamiwe
雅里亚=Maria
雷乌斯=Reus
雷九鸣=Lôi Cửu Minh
雷克托=Rector
雷吉娜=Licia
雷天东=Lôi Thiên Đông
雷天西=Lôi Thiên Tây
雷家堡=Lôi Gia Bảo
雷山居=Lôi Sơn Cư
雷布兰=Labran
雷提耶=Letire
雷海城=Lôi Hải Thành
雷神诀=Lôi Thần Quyết
雷锋塔=Lôi Phong Tháp
雷震君=Lôi Chấn Quân
雷震远=Lôi Chấn Viễn
震天雷=Chấn Thiên Lôi
震字诀=Chấn Tự Quyết
霍元甲=Hoắc Nguyên Giáp
霍夫堡=Hofburg
霍尔墨=Mexico
霍尔姆=Holm
霍尔特=Hokuto
霍库特=Hokuto
霞照剑=Hà Chiếu Kiếm
露丝丝=Runii
霸龙军=Phách Long Quân
青城子=Thanh Thành Tử
青竹阵=Thanh Trúc Trận
青衣楼=Thanh Y Lâu
青门子=Thanh Môn Tử
静流寺=Shizumito
韦莉耶=Villiers
韩子绪=Hàn Tử Tự
韩素文=Hàn Tố Văn
项宵云=Hạng Tiêu Vân
项莫天=Hạng Mạc Thiên
须须木=Sasaki
顾在军=Cố Tại Quân
顾大夫=Cố đại phu
顾惜暮=Cố Tích Mộ
顾惜朝=Cố Tích Triều
顾长歌=Cố Trường Ca
风公度=Phong Công Độ
风远扬=Phong Viễn Dương
风闻白=Phong Văn Bạch
飘缈河=Phiêu Miểu Hà
飘香宫=Phiêu Hương Cung
飘香院=Phiêu Hương Viện
飞云帮=Phi Vân Bang
飞鹰堂=Phi Ưng Đường
飞龙子=Phi Long Tử
食物篮=giỏ đồ ăn
香奈尔=Chanel
香狄翁=Fadion
马克思=Mark
马其诺=Maginot
马兹尔=Mazier
马卡龙=Macaron
马基司=Magoc
马塞尔=Marcel
马奇瓦=Makinoa
马尔丁=Mardin
马尔嘉=Marie
马尔塞=Marce
马掌柜=Mã Chưởng Quỹ
马格纳=Magnus
马爹尼=Martell
马特奥=Matthew
马罗山=Corridor
高不兴=Cao Bất Hưng
高仕铭=Cao Sĩ Minh
高尔顿=Barton
高屋敷=Takayashiki
高风亮=Cao Phong Lượng
鬼焰手=Quỷ Diễm Thủ
鬼神测=Quỷ Thần Trắc
鬼魂路=Quỷ Hồn Lộ
魏建业=Ngụy Kiến Nghiệp
魏忠君=Ngụy Trung Quân
魏无双=Ngụy Vô Song
魏深远=Ngụy Thâm Viễn
魔刀门=Ma Đao Môn
魔天界=Ma Thiên Giới
魔幻界=Ma Huyễn Giới
魔王甲=Ma Vương Giáp
魔神宗=Ma Thần Tông
魔龙珠=Ma Long Châu
鱼池子=Ngư Trì Tử
鱼肠剑=Ngư Trường Kiếm
鲁珂达=Luciada
鲁道夫=Rudolph
鲍望春=Bảo Vọng Xuân
鲜于仇=Tiên Vu Cừu
鸣萧阁=Minh Tiêu Các
鹿野子=Kanoko
麦丹劳=McRonald
麦格纳=Magna
麦积山=Mạch Tích Sơn
麦考特=Malkuth
黄大海=Hoàng Đại Hải
黄天虎=Hoàng Thiên Hổ
黄小加=Hoàng Tiểu Gia
黄希平=Hoàng Hi Bình
黄泉剑=Hoàng Tuyền Kiếm
黄浦江=sông Hoàng Phổ
黄金麟=Hoàng Kim Lân
黄飞鸿=Hoàng Phi Hồng
黑克达=Heiker
黑寡妇=Black Widow
黑手党=Mafia
黑暗界=Hắc Ám Giới
黑河间=Hắc Hà Gian
黑魔岭=Hắc Ma Lĩnh
齐藤始=Saito Hajima
龙之峰=Ryugaku
龙半天=Long Bán Thiên
龙在尘=Long Tại Trần
龙天河=Long Thiên Hà
龙娇娇=Long Kiều Kiều
龙御天=Long Ngự Thiên
龙御翔=Long Ngự Tường
龙晓华=Long Hiểu Hoa
龙爪手=Long Trảo Thủ
龙玉凤=Long Ngọc Phượng
龙碧芸=Long Bích Vân
龙紫雯=Long Tử Văn
龙辰星=Long Thần Tinh
一口=một hơi
一咲=Issa
一大=Kazuhiro(một thứ lớn)
一朗=Ichiro
一朱=Isshu
一郎=Ichiro
丁翔=Đinh Tường
七宝=Thất Bảo
三亚=Sanya
三剑=Mitsurugi
三叶=Clover
三娘=Tam Nương
三家=Sanja
三弘=Mitsuhiro
三月=Mitsuki(tháng 3)
三隅=Misumi
三高=Trường Số 3
不名=Bất Danh
丑奴=Sửu Nô
东云=Shinonome
东凡=Đông Phàm
东宫=Đông Cung
东川=Higashikawa
东林=Đông Lâm
东离=Đông Ly
东野=Higashino
东陵=Đông Lăng
中东=Trung Đông
中原=Nakahara
中早=Trung Tảo
中田=Nakata
中石=Trung Thạch
丰田=Toyota
临檀=Lâm Đàn
临江=Lâm Giang
临澹=Lâm Đạm
丹东=Dandong
丹卡=Dhaka
丽丝=Liss
丽塔=Rita
丽娅=Lya
丽子=Reiko
丽莎=Lisa
丽萨=Lisa
久世=Kuze
久孺=Cửu Nhũ
久远=Orudo
之头=Heddo
乌娜=Oona
乌缇=Wust
乐庭=Nhạc Đình
乐澄=Lạc Trừng
乔乔=Kiều Kiều
乔山=Kiều Sơn
九宝=Cửu Bảo
九条=Kujou
九江=Cửu Giang
九流=Kuryu
九郎=Kuro
乡原=Motogo
乾儿=Càn nhi
二战=World War Ii
二煞=Nhị Sát
二郎=Jiro
云华=Vân Hoa
云天=Vân Thiên
云枫=Vân Phong
云野=Vân Dã
云飞=Vân Phi
五哥=Ngũ Ca
五岛=Goto
五木=Itsuki
亚伯=Abel
亚克=Jak
亚兰=Aram
亚威=Gais
亚子=Yashi
亚文=Avan
亚梦=Ayume
亚洲=Á Châu
亞威=Yai
亞維=Avignon
亨利=Henry
京也=Kyoka
京子=Kyouko
亭儿=Đình nhi
仇枫=Cừu Phong
仓斗=Kuragazu
仓月=Thương Nguyệt
仓玉=Thương Ngọc
仓田=Kurata
仕晨=Sĩ Thần
以沫=Dĩ Mạt
仲仁=Chujin
任为=Nhâm Vi
伊月=Itsuki
伊朗=Iran
伊比=Ibi
伊泽=Izawa
伊玟=Yfel
伊织=Iori
伍斯=Worcester
休兰=Hưu Lan
优一=Yuuichi
优佳=Yuuka
优子=Yuuko
优希=Yuki
优树=Youshi
优特=Uver
优琳=Ylis
伦纳=Sensenbrenner
伯德=Byrd
伯林=Berlin
佐东=Azuma
佐崎=Sasaki
佐惠=Tasumi
佐罗=Zath
佐茅=Sakaya
佐藤=Satou
何琛=Hà Sâm
何飞=Hà Phi
余浪=Dư Lãng
佛利=Bever
佛坂=Futsuwa
佛多=Budsuda
侏罗=Juras
依楠=Kusunoki
依莲=Y Liên
俄浦=Russia
俊吾=Shungo
保罗=Paul
俞斌=Du Bân
修奈=Tinar
倾乾=Khuynh Càn
倾宇=Khuynh Vũ
健次=Kenji
傅宁=Phó Trữ
傑爾=Agere
傲雪=Ngạo Tuyết
儒园=Nho Viện
元宫=Motomiya
元西=Nguyên Tây
光秀=Mitsuhide
克劳=Goer
克尔=Kerr
兔月=Usatsuki
八宝=Bát Bảo
八岛=Yashima
八指=Bát Chỉ
公人=Kimito
六天=Rokuten(6ngày)
六条=Mujo
六道=lục đạo
六院=Lục Viện
兰姨=dì Lan
兰德=Rand
兰特=Rand
关羽=Quan Vũ
兴侣=Koryo
内多=Uchida
内藤=Naito
冈山=Okayama
冈本=Okamoto
冉青=Nhiễm Thanh
军亭=Quân Đình
军家=Quân gia
军昭=Quân Chiêu
军曹=Gunsou
军青=Quân Thanh
冢耶=Otsuka
冢臣=Otsuka Chin
冬五=Đông Ngũ
冬仓=Fusoko
冬至=Toji
冷宿=Lãnh Túc
冷寿=Lãnh Thọ
冷湖=Lãnh Hồ
冷炎=Lãnh Viêm
冷玄=Lãnh Huyền
准藤=Chuẩn Đằng
凉太=Kuruma
凉子=Ryoko
凌卫=Lăng Vệ
凌涵=Lăng Hàm
凌谦=Lăng Khiêm
凌霄=Lăng Tiêu
凛世=Rinyo
凛儿=Lẫm Nhi
凛子=Rinko
凛香=Kinka
凤子=Houko
凤归=Phụng Quy
凤鸣=Phượng Minh
凪纱=Nagisa
凯奇=Cage
凯恩=Kethe
凯撒=Caesar
凯文=Kevin
凯瑞=Carrey
凯萨=Caesar
分雁=Phân Nhạn
刘先=Lưu Tiên
刘刚=Lưu Cương
刘备=Lưu Bị
刘岑=Lưu Sầm
刘表=Lưu Biểu
刚五=Cương Ngũ
创达=Sang Đạt
初濑=Hatsuse
初芝=Hatsushiba
初音=Hatsune
利丝=Lize
利昂=Leon
前园=Koenmae
剑谷=Kiếm Cốc
剑龙=Kiếm Long
加布=Gabe
加德=Gardner
劳叔=Lao thúc
劳尔=Laer
勇作=Yusaku
勇太=Yuta
匈野=Hung Dã
北旗=Bắc Kỳ
北美=Bắc Mĩ
北翰=Bắc Hàn
北越=Bắc Việt
千影=Chikage
千林=Thiên Lâm
千沙=Chisa
千穗=Chiho
千纱=Chisa
千鹤=Chizuru
半藏=Hanzo
华星=Hoa Tinh
华福=Hoa Phúc
华纳=Warner
华锦=Hoa Cẩm
华麟=Hoa Lân
卓然=Trác Nhiên
卓玉=Trác Ngọc
单林=Đan Lâm
南京=Nam Kinh
南凉=Nam Lương
南宫=Nam Cung
南条=Nanjo
南海=Nam Hải
南美=Nam Mĩ
南苑=Nam Uyển
南越=Nam Việt
南里=Minamisato
博勤=Bác Cần
博湖=Bác Hồ
博耀=Bác Diêu
博间=Bác Gian
博陵=Bác Lăng
卡克=Kark
卡尔=Carlos
卡彭=Capone
卡拉=Kara
卡特=Carter
卡罗=Carlo
卡迪=Kard
卡露=Carol
卢克=Luke
卢浮=Louvre
卫奇=Vệ Kỳ
卫平=Vệ Bình
卫潜=Vệ Tiềm
印尼=Indonesia
印度=Ấn Độ
卷哥=Quyển Ca
卿大=Kyodai
卿姨=Khanh Di
厉傲=Lệ Ngạo
原田=Harada
原辻=Haratsugi
友基=Tomonori
友纪=Yuki
双B=Double-B
双喜=Song Hỉ
双煞=Song Sát
叔开=Thúc Khai
叠京=Bắc Kinh
古东=Cotton
古巴=Cuba
古德=Govan
古月=Cổ Nguyệt
可乐=Coca
可汗=Khả Hãn
台湾=Đài Loan
右京=Ukyo
右楯=Yutate
右流=Hugru
叶凛=Diệp Lẫm
叶多=Kanoda
吉乃=Yoshino
吉克=Jiler
吉冈=Yoshioka
吉劳=Jier
吉原=Yoshiwara
吉国=Yoshikuni
吉姆=Jimmy
吉永=Yoshinaga
吉田=Yoshida
吉鲁=Kaku
同国=Đồng Quốc
同泽=Đồng Trạch
吏沙=Risa
吐槽=tsukkomi
吕布=Lữ Bố
君乾=Quân Càn
君仪=Quân Nghi
君悦=Quân Duyệt
君杰=Quân Kiệt
君泰=Quân Thái
君泽=Quân Trạch
君瑞=Quân Thụy
吴耀=Ngô Diệu
周扬=Chu Dương
周昌=Chu Xương
周穆=Chu Mục
周荆=Chu Kinh
和人=Kazuhito(cùng người)
和希=Kazuki
和田=Wada
和美=Kazumi
和臣=Kazuomi
咏临=Vịnh Lâm
咏升=Vịnh Thăng
咏善=Vịnh Thiện
咏棋=Vịnh Kỳ
哇塞=Wase
哈利=Harry
哈特=Hart
哈立=Harry
哈里=Harry
哈雷=Halley
哥德=Gothic
哥特=Gothic
哲弘=Tetsuhiro
唐三=Đường Tam
唐影=Đường Ảnh
唐德=Đường Đức
唐炫=Đường Huyễn
唐雷=Đường Lôi
唐龙=Đường Long
啊威=A Uy
啸天=Khiếu Thiên
喝了=uống ngay
嘉帕=Ziama
四狗=Tứ Cẩu
四界=Tứ Giới
四郎=Shiro
园端=Kogawa
圆香=Madoka
土岐=Toki
圣使=Thánh Sử
圣留=Sansutei
圣美=Hijimei
圭子=Keiko
地榜=Địa Bảng
坂本=Sakamoto
埃及=Ai Cập
城本=Shiromoto
基基=coco
基奴=Keanu
基尔=Cor
基恩=Keane
基拉=Kira
基杰=Jifre
塚耶=Tsuka
塞娜=Serena
塞拉=Seth
塞纳=Senna
境井=Sakaii
墨玉=Mặc Ngọc
墨蝉=Mặc Thiền
士气=sĩ khí
士郎=Shiro
壬生=Mibu
声色=thanh sắc
壹战=World War I
夏尔=Charles
夏洛=Char
夏管=Hạ Quản
夏莉=Charly
夏野=Natsuno
夕雨=Nishiyu
夕颜=Yugao
外崎=Tonosaki
夙川=Shukugawa
多兰=Dalas
夜寻=Dạ Tầm
夜旗=Dạ Kỳ
夜魅=Dạ Mị
大人=đại nhân
大卫=David
大山=Oyama
大島=Oshima
大庆=Đại Khánh
大杉=Osugi
大泽=Osawa
大淼=Đại Miểu
大王=Đại vương
大神=Đại Thần
大黑=Ooguro
天哭=thiên khốc
天女=Tennyo
天晴=trời trong
天祢=Amane
天虎=Tenko
天镔=Thiên Tấn
天靖=Thiên Tĩnh
太一=Taichi
太子=Thái tử
太玄=thái huyền
太郎=Taro
太阴=Thái Âm
央视=Cctv
头条=Midashi
奇克=Cheek
奇拉=Chiile
奇瑟=Kire
奈央=Naoe
奈巳=Nami
奏井=Sou
奥坎=Okanda
奥拉=Olae
奥登=Auden
奥茜=Cecile
奥菈=Olae
好好=hảo hảo
妮可=Nicole
姆杰=Mura
姬乃=Terauchi
姬荻=Himeragi
姬萩=Himeragi
威克=Wick
威利=Wylie
威吉=Gure
威尔=Will
威廉=William
娜娜=Nana
娜迪=Naris
媚姬=Mị Cơ
媞莉=Tsuri
子岩=Tử Nham
子璃=Tử Ly
孔县=Khổng Huyền
孔明=Khổng Minh
孙凉=Tôn Lương
孙梦=Tôn Mộng
孟狄=Mạnh Địch
孟雷=Mạnh Lôi
季霞=Lixia
宁燕=Trữ Yến
宁舒=Trữ Thư
安兹=Ainz
安娜=Anna
安巡=An Tuần
安棱=An Lăng
安泊=Park
安燃=An Nhiên
安琪=Angel
安科=Bianco
安荷=An Hà
安藤=Andou
安迪=Ende
安阳=An Dương
宋石=Tống Thạch
宋越=Tống Việt
宏旭=Hoành Húc
宗像=Munakata
宙斯=Zeus
定云=Định Vân
宝时=Porsche
室田=Murota
室道=Murodo
宫川=Miyakawa
宴亭=Yến Đình
宵奈=Xinar
家慧=Hoa Tuệ
容克=Juncker
容恬=Dung Điềm
容虎=Dung Hổ
宾利=Bentley
宾塔=Binta
密斯=Smith
富士=Fuji
寒鹰=Hàn Ưng
封旗=Phong Kỳ
将吾=Masago
将悟=Shogo
尊乡=Takashido
小五=Tiểu Ngũ
小亮=Tiểu Lượng
小今=Kyoko-chan
小冢=Otsuka-san
小凡=Tiểu Phàm
小凤=Tiểu Phượng
小刚=Takeshi
小华=Hana-chan
小夏=Honoka-san
小夜=Sayo
小婉=Tiểu Uyển
小帆=Honoka-san
小明=Asuta-chan
小晴=Akatsuki
小朝=Asa-chan
小玄=Tiểu Huyền
小玉=Tama
小留=Michiru-san
小秋=Aki-chan
小紫=Shiori-chan
小红=Aka-chan
小羽=Tiểu Vũ
小舞=Tiểu Vũ
小葵=Aoi-chan
小谷=Kotani
小野=Ono
小鸠=Hato-chan
小麟=Tiểu Lân
小麦=Komugi
少商=Thiếu Thương
尤美=Yuumi
尤莉=Julie
尼姆=Nimes
尼娜=Nina
尾上=Onoue
展昭=Triển Chiêu
展玉=Triển Ngọc
屠天=Đồ Thiên
屠龙=Đồ Long
山井=Yamai
山田=Yamada
岩田=Iwata
岳凡=Nhạc Phàm
岸川=Kishikawa
峨眉=Nga Mi
崎守=Sakimori
崔蘭=Kheran
左京=Sakyo
巧雪=Koyuki
巫师=pháp sư
巴克=Buck
巴布=Babus
巴特=Bart
巴黎=Paris
帆南=Hanna
帆夏=Honoka
希嘉=Higra
希塞=Greek
希娅=Hia
希尔=Hill
希斯=Hiss
希美=Nozomi
希腊=Hy Lạp
帕恩=Marc
帝野=Mikadono
帝门=Mikado
席格=Siegel
席瓦=Silva
席马=Silma
常广=Tsuhiro
年锦=Niên Cẩm
幸田=Koda
幻魅=Huyễn Mị
幽徒=Kasoketo
广州=Quảng Châu
广志=Hiroshi
广水=Wamitsu
广濑=Hirose
庄周=Trang Chu
庄濮=Trang Bộc
庆人=Keito
庆军=Khánh quân
庆彰=Khánh Chương
庆离=Khánh Ly
庆鼎=Khánh Đỉnh
库拉=Krar
库鲁=Kourou
延喜=Duyên Hỉ
开龙=Khai Long
异人=Dị Nhân
异羽=Yiku
式部=Shikibu
弓月=Yuzuki
弗兰=Fran
弘人=Hiroto
弘华=Houka
弘子=Hiroko
张季=Trương Quý
张飞=Trương Phi
弥生=Yayoi
强尼=Johnny
彩京=Saiyako
彼得=Peter/Bỉ Đắc
徐元=Từ Nguyên
徐旭=Từ Húc
御影=Mikage
御泉=Ngự Tuyền
御雷=Yurei
微软=Microsoft
德尚=Desche
德川=Tokugawa
德斯=Sanders
德林=Durling
德萨=German
心心=Kokoro
心月=Tâm Nguyệt
志波=Shiba
忘尘=Vong Trần
念微=Niệm Vi
念悟=Niệm Ngộ
怜子=Reiko
思廉=Tư Liêm
思蔷=Tư Sắc
恋子=Renko
恒夜=Hằng Dạ
恩德=Ende
恭子=Kyoko
恺撒=Ceasar
悠妮=Yuri
悠斗=Yuma
悲梦=Bi Mộng
惜朝=Tích Triều
惠理=Eri
惠美=Emi
愁山=Yutsuoka
慎吾=Shingo
慕轲=Mộ Kha
戌威=Jouji
戎席=Nhung Tịch
成国=Thành Quốc
成宫=Narumiya
成惠=Megumi
戒禅=Giới Thiện
戴普=Depp
户马=Kazokuba
才谷=Saitani
扎克=Jack
托尼=Tony
托林=Torin
承悦=Thừa Duyệt
抓了=bắt giữ
拉卡=Lyah
拉古=Lager
拉斐=Rafael
拉枪=Latin
拉格=Lager
拉菲=Lafite
拉里=Larry
拓真=Takuma
捷林=Lincoln
捷达=Jetta
掉牙=Đài Loan
提奥=Theo
提特=Teere
提莉=Tsuri
摩西=Moses
摩里=Mory
撒旦=Satan
敦煌=Đôn Hoàng
文伟=Văn Vĩ
文夫=Fumio
文煞=Văn Sát
斋贺=Saiga
断背=Brokeback
斯坦=Stalin
斯诺=Snow
斯达=Star
斯隆=Sloan
新宫=Aramiya
新横=Shinyoko
方八=Phương Bát
方敌=Phương Địch
方标=Phương Tiêu
旗亭=Kỳ Đình
无尘=Vô Trần
日公=Nhật Công
日向=Hinata
日奈=Hina
日崎=Hizaki
日昭=Nhật Chiêu
日本=Nhật Bản
日野=Hino
早美=Sobi
早苗=Sanae
明威=Minh Uy
明溪=Minh Khê
易园=Dịch Viên
易水=Dịch Thủy
易风=Dịch Phong
星川=Hoshikawa
星扬=Tinh Dương
星瞰=Eugene
映见=Hami
春太=Haruta
春奈=Haruna
春斗=Haruto
春海=Harumi
昭北=Chiêu Bắc
晚晴=Vãn Tình
普顷=Putin
景介=Keisuke
暗山=Kurayama
暗雨=Ám Vũ
曼谷=Băng Cốc
曾明=Tằng Minh
最近=gần đây
月芽=Nguyệt Nga
月读=Tsukiyomi
朋彦=Tomohiko
朋美=Tomomi
朗姆=Rum
朝地=Asaji
朝安=Hướng An
朝歌=Triêu Ca
朝衣=Asai
朝颜=Asagao
朝鲜=Triều Tiên
木原=Kihara
木崎=Kisaki
木月=Mộc Nguyệt
木村=Kimura
木枕=Kimakura
木灌=Kijuten
未散=Michiru
未镜=Vị Kính
本田=Honda
札克=Zach
朱丽=Julie
朱喜=Chu Hỷ
朴戎=Phác Nhung
权田=Gonda
杉山=Sugiyama
杉崎=Sugisaki
李勤=Lý Cần
李浩=Lý Hạo
李潭=Lý Đàm
李继=Lý Kế
李维=Levi
李耀=Lý Diệu
李肖=Lý Tiếu
杏奈=Anna
杏子=Anzu(hạnh)
村上=Murakami
村田=Murata
杜力=Đỗ Lực
杜尘=Đỗ Trần
杜尚=Duchamp
杜维=Đỗ Duy
杜风=Đỗ Phong
来待=Kimachi
杨微=Dương Vi
杨明=Dương Minh
杨过=Dương Quá
杨逍=Dương Tiêu
杰丝=Jessi
杰克=Jack
杰利=Jerry
杰夫=Jeff
杰尔=Ketra
杰森=Jason
杰米=Jamie
杰西=Kiệt Tây
松井=Matsui
松平=Matsudaira
松沼=Matsunuma
松田=Matsuda
松腾=Tùng Đằng
林信=Lâm Tín
林克=Will
林功=Lâm Công
林城=Lean
林擒=Ringo
林田=Hayashida
林眺=Lâm Thiếu
林肯=Lincoln
林芳=Lâm Phương
林荫=Lâm Ấm
林齐=Lâm Tề
枪羽=Yariba
枯野=Dorai
柊木=Hiragiku
柏娜=Huna
柏木=Kashiwagi
柏札=Hobda
染菊=Nhiễm Cúc
查克=Chuck
查猜=Richard
查理=Charles
柳逸=Liễu Dật
栗栖=Kurisu
栗梦=Kurimu
根雪=Neyuki
格力=Gree
桃乃=Momowa
桃代=Mosedai
桃惠=Mogumi
桃香=Momoka
桐世=Kiriyo
桐子=Kiriko
桐山=Kiriyama
桐生=Kiryuu
桐谷=Kiriya
桑边=Sandy
桑迪=Sandy
梁山=Lương Sơn
梁非=Lương Phi
梅亚=Meyer
梅儿=Mael
梅尔=Mael
梅布=Meibu
梅江=Mai Giang
梅洛=Maes
梅莉=Marga
梅野=Umeno
梅露=Merlot
梅香=Mai Hương
梓侬=Tử Nông
梦棠=Mộng Đường
梨梨=Riri
梨花=Rika
梨雪=Lê Tuyết
梨香=Rika
梵高=Van Gogh
棋亭=Kỳ Đình
森川=Morikawa
森本=Morimoto
森田=Morita
森耶=Sâm Gia
森部=Moribe
棹砥=Saoto
椎名=Shiina
楚孝=Sở Hiếu
横山=Yokoyama
横岛=Yokoshima
横滨=Yokohama
樱丘=Sakuragaoka
樱子=Sakurako
樱桃=Sakura
樱江=Koei
樱泽=Ousawa
樱野=Sakurano
橘轩=Quất Hiên
檐角=góc mái hiên
欧洲=Âu Châu
欧美=Âu Mĩ
欧芳=Eupra
歌德=Goethe
歌特=Gothic
歌顿=Gordon
正平=Shohei
正木=Masaki
正树=Masaki
正梦=Nayume
正臣=Masaomi
正风=Shofu
武谦=Vũ Khiêm
殷凡=Ân Phàm
毒岛=Busujima
比克=Cadic
比利=Billy
比叡=Hiei
比尔=Bill
毕天=Tất Thiên
水兰=Ounabara
水若=Thủy Nhược
水谷=Mizutani
永全=Vĩnh Toàn
永敛=Vĩnh Liễm
永殷=Vĩnh Ân
永逸=Vĩnh Dật
汀娜=Tingna
汉林=Hansen
汉森=Hansen
汐留=Shiodome
汗森=Hansen
江凯=Giang Khải
江古=Kofra
江畔=bờ sông
池本=Ikemoto
汤姆=Tom
汪翔=Uông Tường
汴京=Biện Kinh
沃顿=Worton
沙加=Saga
沙枝=Saki
沙树=Saki
沙珈=Shajar
沙织=Saori
沙罗=Charo
沙耶=Saya
沢城=Sawashiro
沧月=Thương Nguyệt
河内=Hà Nội
河田=Kawada
法恩=Fael
法连=Farian
法雷=Farr
法露=Hodo
波奇=Poch
波娜=Banaa
波特=Potter
波雷=Compaor
波霜=Namishimo
波霸=Boba
泥暗=Neo
泰国=Thailand
泰岩=Thái Nham
泰格=Tiger
泰蚕=Thái Tàm
泰造=Taizou
泽豪=Trạch Hào
洁妮=Jenny
洁娜=Jina
洗髄=Tẩy Tủy
洛云=Lạc Vân
洛克=Locker
洛基=Rocky
洛宁=Lạc Trữ
洛德=Rod
洛琴=Lạc Cầm
洛辛=Lạc Tân
洪大=Hồng Đại
流夜=Lưu Dạ
浅野=Asano
浅黄=Asagi
浴池=dục trì
海伦=Helen
海南=Hải Nam
海德=Hyde
海昙=Hải Đàm
海蓉=Hải Dong
海顿=Haydon
涅卡=Prata
淑妃=Thục Phi
深夏=Minatsu
深川=Fukagawa
深栖=Fukasu
深闲=Fukaido
清一=Seiichi
清华=Sekain
清川=Kiyokawa
清虚=Thanh Hư
清越=Thanh Việt
清阳=Thanh Dương
渥姆=Wone
港澳=Hong Kong
港片=Hongkong
游佐=Yusa
漆原=Urushihara
漆源=Urushihara
潮州=Triều Châu
澄实=Sumire
澈儿=Triệt Nhi
澳门=Macao
濑利=Riseto
灯里=Akari
灰原=Haihara
炎烈=Viêm Liệt
炎黄=Viêm Hoàng
炙天=Chích Thiên
烈儿=Liệt Nhi
烈斗=Liệt Đấu
热海=Atami
熙尤=Hi Vưu
燕宝=Yến Bảo
燕玉=Yến Ngọc
燕贵=Yến Quý
爱佳=Aika
爱榭=Alsia
爱沢=Tokowai
爱滋=Aids
爱羽=Airou
爱莱=Rena
爱菜=Rina
爱衣=Aifuku
牧子=Makiko
牧濑=Makise
牧野=Makino
特勒=Hitler
犹大=Judas
狄伦=Dylan
狐火=Kitsunebi
狮鹫=Griffin
猪木=Inoki
猫叉=Nekomata
猫柳=Nekoyanagi
猫桐=Nekokiri
猫王=Elvis
猿江=Sarue
玄人=Kurouto
玄夜=Huyền Dạ
玄宿=Huyền Túc
玄教=Huyền Giáo
玄景=Huyền Cảnh
玄木=Huyền Mộc
玄武=Huyền Vũ
玄沃=Huyền Ốc
玄泠=Huyền Linh
玄涣=Huyền Hoán
玄澈=Huyền Triệt
玄玉=Huyền Ngọc
玄生=Huyền Sanh
玄阴=Huyền Âm
玉兰=Magnolia
玉田=Tamada
玉箫=Ngọc Tiêu
玉诀=Ngọc Quyết
王充=Vương Sung
王振=Vương Chấn
王花=Ohana
玛丽=Mary
玛拉=Mara
玛沙=Mast
玛法=Mafra
现充=riajuu
现在=hiện tại
珠江=Châu Giang
理惠=Rie
理璃=Lily
理绪=Rio
琴音=Kotone
琼斯=Jones
瑛儿=Anh Nhi
瑞京=Thulus
瑞尔=Farrell
瑞平=Mizuhira
瑞恩=Ryan
瑞清=Thụy Thanh
瑞王=Thụy Vương
瑞穗=Mizuho
瑞轩=Thụy Hiên
瑟拉=Seucrat
瑶光=Dao Quang
璜特=Hwara
甄徐=Chân Từ
甘札=Gant
甜心=Sweetheart
田中=Tanaka
田坂=Tasaka
田所=Tadokoro
甲元=Komoto
甲良=Kora
痴汉=thằng ngốc
白亚=Hakua
白宫=Nhà Trắng
白川=Shirakawa
白惠=Shiroe
白旭=Bạch Húc
白樱=Shirazakura
白虎=Bạch Hổ
的雅=Miyabi
皮特=Pitt
皮萨=Pizza
盖瑞=Gary
盖茨=Gates
盖达=Al-Qaeda
直子=Naoko
直纯=Chokujun
相坐=Aisuwa
相川=Aikawa
相田=Aida
真冬=Mafuyu
真哉=Shinya
真奥=Maou
真岸=Magishi
真爱=Sanae(tình yêu)
睦月=Mutsuki
睦美=Mutsumi
瞳儿=Đồng Nhi
矢上=Yagami
矢嶋=Yajima
知佳=Chika
知弦=Chizuru
砥磨=Dimar
碧娜=Benazir
碧痕=Bích Ngân
碧阳=Hekiyou
碰太=Ponta
神凪=Kannagi
神崎=Kanzaki
神座=Kanza
神臣=Kanomi
神针=Thần Châm
神领=Jinryou
祥奉=Tường Phụng
祥子=Shoko
禄卫=Lộc Vệ
福武=Fukutake
离儿=Ly Nhi
离国=Ly Quốc
离尉=Ly Úy
离燕=Ly Yến
秋叶=Akiba
秋容=Thu Dung
秋山=Akiyama
秋星=Thu Tinh
秋晴=Akiharu
秋月=Shugetsu
秋津=Akatsu
秋篮=Thu Lam
秋蓝=Thu Lam
科特=Scott
秦德=Tần Đức
秦政=Tần Chính
秦正=Tần Chính
秦羽=Tần Vũ
秦重=Tần Trọng
秦风=Tần Phong
稀粥=cháo loãng
穆诺=Munoc
穹渊=Khung Uyên
空户=Sorato
空流=Không Lưu
空蝉=Utsusemi
突厥=Đột Quyết
竹仙=Trúc Tiên
竹怜=Trúc Liên
笠取=Kasatori
笹島=Sasajima
筑玄=Trúc Huyền
简惠=Giản Huệ
篠田=Shinoda
米亚=Mia
米兰=Milan
米娜=Mina
米泽=Mathas
米罗=Miro
米莉=Milly
米迦=Miga
紗子=Sako
素堂=Tố Đường
素衣=Tố Y
索伦=Solon
索克=Sauk
索姆=Som
索娜=Sona
索恩=Thorne
索抹=Faso
索林=Sorin
索菲=Sophie
紫凛=Tử Lẫm
紫宸=Tử Thần
紫网=tử võng
紫苑=Aster/Shion
紫阳=Tử Dương
繁佳=Phồn Giai
红沙=Gaza
红莲=Hồng Liên
红蝎=Hồng Hạt
红袍=Hồng Bào
约南=Việt Nam
纪子=Noriko
纪悠=Kỷ Du
纯傲=tsunpure
纱优=Sahiyu
纱砂=Sasa
纱织=Saori
纱鸟=Satori
纽约=New York
织女=Uiba
织户=Orido
织田=Oda
绍北=Thiệu Bắc
绘理=Erika
绚斗=Genbatsu
绛莲=Giáng Liên
绫乃=Ayano
绫女=Ayano
绫音=Ayane
绯影=Hisaki
维尔=Neville
维幔=Kāten
维恩=Wien
维斯=Reeves
绵涯=Miên Nhai
绿蛾=Lục Nga
绿银=Lục Ngân
缅甸=Myanmar
缇缇=Tili
缇雅=Tina
缪斯=Muse
罗兰=Roland
罗卡=Roke
罗塞=Rosello
罗威=Rottweiler
罗宾=Robin
罗德=Rod
罗林=Rollin
罗格=Rogge
罗琳=Rowling
罗登=Roden
罗莲=Lucy
罗西=Rossi
罗迪=Roddy
羊饲=Hitsugi
美咲=Misaki
美国=Mĩ Quốc
美希=Miki
美樱=Myme
美琴=Mikoto
美辉=Miki
美里=Misato
美雪=Miyuki
群傲=Quần Ngạo
羽妃=Vũ Phi
羽岛=Hashima
翘毛=Aisuke
翠香=Thúy Hương
耕介=Kousuke
耶宵=Yashio
耶撒=Yesa
耶稣=Jesus
耶鲁=Yale
聊盟=Liêu Minh
育野=Ikuno
背背=Bối Bối
胡峰=Hồ Phong
胡斐=Hồ Phỉ
腕力=Waroku(nắmđấm)
自慰=thẩm du/ xD... thủ dâm
舒歌=Thư Ca
舞儿=Vũ Nhi
舞莉=Dansuri
舞裳=Vũ Thường
良太=Ryota
良子=Ryoko
艾伦=Alan
艾娃=Eva
艾娜=Inari
艾尔=Al
艾文=Alvin
艾欧=Aur
艾滋=Hiv
艾米=Emi
艾美=Eme
芊芊=Thiên Thiên
芙蕖=Phù Cử
芙蕾=Winfrey
芦屋=Ashiya
芬利=Finley
芬城=Phân Thành
芬莱=Finlay
花冠=Corona
花恋=Karen
花旗=Hoa Kì
花梨=Karin
花江=Hanae
花珞=Hoa Lạc
花里=Hanazato
花野=Hanano
花青=Hoa Thanh
芷清=Chỉ Thanh
芷若=Chỉ Nhược
芷贞=Chỉ Trinh
芽衣=Mei
苍冥=Kura Akira
苍玉=Thương Ngọc
苍颜=Thương Nhan
苏伊=Tô Y
苏容=Tô Dung
苏珊=Susan
苏菲=Sophie
若明=Nhược Minh
若木=Murasaki
若浩=Nhược Hạo
若渊=Nhược Uyên
若澈=Nhược Triệt
若琳=Nhược Lâm
若离=dường như xa cách
若紫=Waramurasaki
若言=Nhược Ngôn
若贤=Nhược Hiền
若风=Nhược Phong
英伦=nước Anh
英尼=Anh Quốc
荆州=Kinh Châu
草野=Kusano
荒崎=Arasaki
荒木=Araki
荣虎=Vinh Hổ
药王=Dược Vương
药皇=Dược Hoàng
药郎=Dược Lang
莉丝=Lize
莉亚=Lea
莉娜=Lina
莉子=Reiko
莉斯=Liza
莉莎=Lisa
莎拉=Sarah
莫卜=Mobou
莫拉=Mola
莫桀=Mordred
莫离=Mạc Ly
莫翼=Mạc Dực
莫里=Moree
莱奥=Leo
莱恩=Ryan
莱拉=Lailah
莱茵=Rhino
莲井=Hasui
莲亿=Liên Ức
莳野=Jisei
菊川=Kikugawa
菊池=Kikuchi
菲亚=Fiya
菲儿=Mayfair
菲娅=Fiya
菲特=Fhuss
菲雅=Lamina
萝丝=Rose
萝泽=Louse
萧烈=Tiêu Liệt
萧纵=Tiêu Túng
萧语=Tiêu Ngữ
萨利=Sally
萨莉=Sally
落雪=Lạc Tuyết
葛西=Kansai
葛达=Gera
葵桑=Aoi-chan
蒂卡=Tica
蓝巽=Lam Tốn
蓝泽=Lam Trạch
蓝跃=Lam Dược
蓝齐=Lam Tề
蔡司=Thái Tư
蔷薇=Shoubi
蕾姆=Leimu
蕾媞=Lashi
蕾欧=Leiou
蕾蒂=Ladi
薇恩=Vira
藤乃=Fujino
藤堂=Toudou
藤壶=Fujitsubo
藤宫=Fujimiya
藤昭=Fujiaki
藤田=Fujita
虎口=lòng bàn tay
虎王=Hổ Vương
蜜雅=Miya
蝉谷=Semitani
螯拜=Ngao Bái
血厉=Huyết Lệ
血界=Huyết Giới
衣楠=Kusunoki
衮郡=Cổn quận
袁独=Viên Độc
裳衣=Thường Y
西卡=Sika
西斯=Sith
西端=Tây Đoan
西罗=Ciro
西芒=Simao
西陵=Tây Lăng
西雷=Tây Lôi
觉然=Giác Nhiên
觉颠=Giác Điên
詹尼=Gianni
许严=Hứa Nghiêm
许侑=Hứa Hựu
许洁=Hứa Khiết
诗怜=Utano
诗猫=Utaneko
诸葛=Gia Cát
诺亚=Naire
诺瓦=Nol
诺艾=Noel
诺顿=Norton
谭亮=Đàm Lượng
谷縝=Cốc Chẩn
豁城=Khoát thành
豆豆=Đậu Đậu
貂禅=Điêu Thuyền
貢茲=Gon
賽卡=Sara
贝尔=Bell
贝松=Besson
贝瑞=Berry
贝贝=Bối Bối
贞夫=Sadao
贞子=Fuko
贤悟=Kengo
贤梧=Keigo
贯井=Ikkamo
贺狄=Hạ Địch
贾正=Cổ Chánh
贾缘=Cổ Duyên
贿络=hối lộ
赌城=Las Vegas
赐官=Tứ Quan
赐少=Tứ thiếu gia
赖光=Raiko
赛恩=Thain
赛特=Dorset
赛莉=Tali
赤兔=Xích Thố
赤城=Akagi
赤尔=Seoul
赤川=Akagawa
赤神=Akagami
赤诚=Akagi(chân thành)
赫德=Hod
赫拉=Hera
赵宏=Triệu Hoành
越儿=Việt Nhi
越家=Việt gia
路易=Louis
路苍=Lộ Thương
路薩=Lusa
辰南=Thần Nam
达克=Duck
达利=Dalits
达哉=Tatsuya
达因=Dyne
达尔=Dale
迁都=Shuto
过去=qua đi
迈亚=Miami
迈力=Malus
迈可=Michael
迈耶=Meyer
近江=Oumi
进兴=Tiến Hưng
连云=Liên Vân
连伯=Liên Bá
连言=Liên Ngôn
连雀=Renjaku
迦德=Jared
迦纳=Guana
迪伊=Dirac
迪克=Dick
迪奥=Diaz
迪科=Dike
追命=Truy Mệnh
追梦=Truy Mộng
逆炎=Nghịch Viêm
逛逛=ngao du
造田=Farran
逢坂=Osaka
道园=Đạo Viện
道格=Douglas
邦和=Kunikazu
邦德=Bond
邪光=Tà Quang
郑关=Trịnh Quan
郑军=Trịnh Quân
郭敖=Quách Ngao
郭靖=Quách Tĩnh
采锵=Thái Thương
采青=Thái Thanh
里中=Satonaka
里德=Reed
里穗=Riho
里空=Riku
里美=Satomi
野宫=Nomiya
野芽=Nome
金惠=Jinroe
金炼=Kim Luyện
金赛=Kinsey
金辽=Kim Liêu
鎌月=Kamazuki
钱盼=Tiễn Phán
铁恨=Thiết Hận
铁手=Thiết Thủ
铃乃=Suzuno
铃原=Suzuhara
铃木=Suzuki
铃桥=Lin
铃莉=Lifner
铃菜=Suzuna
铃野=Takane
铃音=Chakumero(nhạc chuông)
银花=Ginga
锅田=Nabeta
锐二=Eiji
锦飞=Cẩm Phi
键一=Kenichi
镰月=Kamazuki
长柳=Trường Liễu
间中=Ichibu
闻希=Văn Hi
阎君=Diêm Quân
阎通=Diêm Thông
阳洙=Dương Thù
阴厉=Âm Lệ
阴尸=Âm Thi
阿兹=Aziz
阿农=Anund
阿土=A Thổ
阿威=A Uy
阿季=A Quý
阿忘=A Vong
阿拉=Alas
阿杰=A Kiệt
阿棋=A Kỳ
阿泽=A Trạch
阿眉=A Mi
阿福=A Phúc
阿翼=A Dực
阿贝=Abbe
阿里=Ali
阿镶=A Tương
陆云=Lục Vân
陆德=Lund
陆月=Mitsuki
陆虎=Land Rover
陈兰=Trần Lan
陈阳=Trần Dương
院长=viện trưởng
陸漸=Lục Tiệm
隼人=Hayato
雄单=Hùng Đan
雅之=Masayuki
雅克=Jacques
雅园=Nhã Viên
雅树=Masaki
雅纪=Masaki
雅虎=Yahoo
雏子=Hinako
雏菜=Hinana
雪儿=Tuyết Nhi
雪卿=Tuyết Khanh
雪拉=Sheila
雪江=Yukie
雪涵=Tuyết Hàm
雪男=Yeti
雪菈=Sheila
雪见=Yukimiru
雪郎=Tuyết Lang
雪雁=Tuyết Nhạn
雷乌=Ru
雷卫=Lôi Vệ
雷卷=Lôi Quyển
雷吉=Regir
雷奇=Dou
雷奥=Luis
雷姆=Leim
雷德=Lodine
雷斯=Lise
雷昂=Lyone
雷柔=Lôi Nhu
雷火=Rakurai
雷蒙=Raymond
雷达=Rađa
雾姬=Kirimo
雾生=Kiryu
霍垣=Honel
霍娜=Huna
霍格=Hogue
霞照=Hà Chiếu
霧沢=Kirisawa
露妲=Ludia
露娜=Luna
露法=Luna
露茜=Lucy
露露=Ruru
静冈=Shizuoka
静月=Tĩnh Nguyệt
静流=Shizuru
静鹤=Seikuren
非亚=Mina
靳云=Cận Vân
韦尔=Ware
韩国=Hàn Quốc
韩岂=Hàn Khởi
韩拓=Hàn Thác
韩月=Hàn Nguyệt
韩立=Hàn Lập
韩若=Hàn Nhược
頭条=Midashi
顷以=Khoảnh Dĩ
项广=Hạng Nghiễm
顾隆=Cố Long
颜迪=Nhan Địch
风祭=Fuko
风铃=Phong Linh
风驰=Phong Trì
飞貂=chồn bay
飞飞=Momo(n)
飞鸟=Asuka(phi điểu)
飨庭=Aeba
馄饨=hoành thánh
香港=Hongkong
香澄=Kasumi
香焚=Hương Phần
香绘=Kae
香芸=Hương Vân
马丁=Martin
马克=Mark
马林=Marin
马赛=Marseilles
高丽=Triều Tiên
高奇=Gauci
高宫=Takamiya
高志=Takashi
高林=Takabayashi
高梨=Takanashi
高虎=Takatora
高酉=Cao Dậu
高野=Takano
鬼仙=Quỷ Tiên
鬼域=Quỷ Vực
鬼宗=Quỷ Tông
鬼帅=Quỷ Soái
鬼灯=Hoozuki
鬼煞=Quỷ Sát
鬼王=Quỷ Vương
鬼魂=Quỷ Hồn
魅花=Mika
魏冲=Ngụy Trùng
魔佛=Ma Phật
魔域=Ma Vực
魔宗=Ma Tông
魔影=Ma Ảnh
魔珠=Ma Châu
魔门=Ma Môn
魔陀=Ma Đà
魔魅=Ma Mỵ
鲁曼=Ruman
鲁郞=Nonus
鲍伯=Bob
鲔吞=Tuna Eater
鲛岛=Sashima
鴨居=Kamui
鸠子=Hatoko
鸣丈=Chomei
鸣儿=Minh nhi
鸣王=Minh vương
鸣阳=Minh Dương
鸭居=Ahira
鸿运=Hồng Vận
鹤真=Tsuruma
鹰乃=Hio
鹰奈=Hio
鹿丹=Lộc Đan
麒儿=Kỳ Nhi
麟少=Tiểu Lân
麻矢=Maya
麻菜=Mana
黄升=Hoàng Thăng
黄泉=Acheron
黄蓉=Hoàng Dung
黎诺=Lino
黑惠=Kuroe
黑江=Kurokawa
黑河=Hắc Hà
默言=Mặc Ngôn
齐儿=Tề Nhi
齐格=Christian
齐藤=Saito
龙天=Long Thiên
龙月=Long Nguyệt
龙江=Long Giang
龙霄=Long Tiêu
龙马=Ryuma
龙魂=Long Hồn
京=Kyo
借=mượn
凛=Las
凤=Fuou
凪=Nagi
凯=Kai
办=lo liệu
华=Hana/Hoa(TQ)
卓=Suguru
只=chỉ
咦=a
啦=rồi
堺=Sakai
夕=Yuu
奏=Kanade(tấu)
尔=Ér
布=Bố/Br
希=Yi/Nozomi
彪=Aya
拐=lừa gạt
推=đẩy
春=Haru
杉=Sugi
枫=Kaede
柊=Hiiragi
柳=Yanagi
润=Ran
玉=Tama
珣=Joushun
琼=Joan
纲=Gae
翼=Tsubasa(cánh)
胧=Luch
良=Ryo
莉=Rei
萨=Sa
萼=Utena
葵=Aoi
薰=Kaoru
藤=Fuji
谰=Lan
越=càng
迪=Dir
鍵=Ken
镜=Kagami
雏=Hiina
三原=Mihara
佳奈美=Kanami
安德森=Anderson
塞拉菲姆=Seraphim
夜野=Yoru
萨拉斯=Saras
萨拉斯巴迪=Sarasvati
史特拉第瓦里=Stradivari
康帝=Conti
阿里耶尔=Ariel
平松=Hiramatsu
友纪纪=Yukinori
辉罗罗=Kirara
史考菲=Schofield
威森=Wesson
乔治=George
栗须=Kurisu
娑罗室=Saras
娑罗室伐底=Sarasvati
彩香=Ayaka
克莉丝=Chris
安德烈=Andrea
卡巴迪=Kabaddi
史丹=Stan
妙子=Taeko
妮妮=Nene
妮葛蕾莉亚=Naegleria
妮比罗丝=Nebiros
马丁尼=Martini
拉欧=Kaoh
拳四郎=Kenshiro
婆罗室=Saras
莉莉亚=Lilia
莉莉丝=Lilith
鲍尔=Bauer
下村=Shimomura
克莉伍德=Clidwood
摩莉欧=Mario
瓦尔特=Walther
贝瑞塔=Beretta
杜拜斯=Dew Weiss
卡拉什尼科夫风=Kalashnikov
科莫多=Komodo
文字夫=Mojioto
斗莉王=Tolio
美莲葛=Meringue
沙贝利亚=Salveria
步美=Ayumi
杜拉克=Durak
阿罗迪斯=Aroldis
查普曼=Chapman
友纪基=Yukinori
欧尔克博鲁德=Orcrist
风原=Kazamoto
月桂院=Laurelia
索菲亚=Sofia
玛莉=Mari
夏尔斯提亚=Shirestia
野野山=Nonoyama
夏斯提亚=Shirestia
玛格丽=Margery
玛格丽塔=Magarita
赛勒涅=Selene
卡匹拉奇=Carpilary
凪人=Nagihito
高杉晋=Takatsugi
织野=Orinose
笼岛=Keshima
笼岛谛=Keshima Akira
织野菜=Orinose Ryori
红莉亚=Reddea
琉雷=Lucos
神乐井=Kagurai
毛妞美=Kashojomi
久我山=Kugayama
柾木=Masaki
闪亮子=Azayako
星空闪亮子=Hoshi Azayako
冷娇=Kuudere
克莉亚=Calea
桔梗院=Kikyoin
柚希=Yuuki
筱濑=Oze
筱濑戒=Oze Akirame
土御门=Tsuchimo
仙三=Senzou
玉藻前=Tamamo No Mae
大辉=Taiju
欧西里=Oshiri
欧西里斯=Osiris
桃太郎=Montaro
斋条=Tekijo
机械降神=Deus Ex Machina
读贺=Yomiga
衣里=Eri
佛雷姆哈特=Flameheart
塞尔尼娅=Sernia
大地薰=Daichi Kaoru
吉住=Yoshiyumi
美美那=Mimina
灯一郎=Koiichiro
塞尔妮亚=Sernia
南云始=Minamiun Hajime
南云=Minamiun
白崎=Shirasaki
香织=Kaori
八重=Yae
八重樫=Yaegashi
雫=Shizuku
天之河=Amanogawa
坂上=Sakagami
龙太郎=Ryutaro
托达斯=Tudale
伊什塔尔=Ishtar
梅尔德=Meide
桧山=Hiyama
信治=Shinji
巴西利斯克=Basilisk
多纳尔=Donner
惠里=Eri
中村=Nakamura
谷口=Taniguchi
小惠里=Eri-chan
兰迪尔=Randhir
莉莉安娜=Liliana
奥斯卡=Oscar
奥尔库司=Mastora
希雅=Shia
郝里亚=Horlia
卡姆=Kamm
基鲁=Jir
艾尔夫雷利克=Aeferdica
札姆=Gham
马欧=Maor
鲁亚=Lua
格杰=Kach
茱莉亚=Julia
帕鲁=Peru
雷根=Reagan
邦顿=Brado
巴鲁多费鲁多=Balor Pilor
顿透=Durto
莱森=Clarkson
哈尔崔那=Haerna
凯萨琳=Catherine
狄洛斯=Discat
密雷迪=Miredia
妮亚=Nia
淳史=Atsushi
相川升=Aikawa Rittoru
仁村=Nimura
玉井=Tamai
菅原=Sugawara
宫崎=Miyazaki
奈奈=Nana
永山=Nagayama
优花=Yuka
园部=Sonobe
爱子=Aiko
奥尔康=Alcorn
亚占提姆=Adamantine
茉娜=Mona
艾谢=Ayse
哈蒂姆=Khadim
哈蒂耶=Hedyeh
阿夫拉姆=Abraham
二叶=Futaba
塞尔尼亚=Sernia
琵娜=Pina
斯佛姆克兰=Sformklan
斯佛=Sift
浦泽=Urasawa
夏卡尔=Chagall
萨尔茨堡=Salzburg
木田=Kida
阿部=Abe
阿部井=Abe Yoku
美佳子=Mikako
琢巳=Takumi
高杉=Takatsugi
优作=Yuusaku
涌井=Wakui
伊菲莉娜=Ithilina
菲陆尔=Felier
霍夫曼=Hoffman
由梨子=Yuriko
健一=Kenichi
里奈=Rina
和泉=Izumi
朋子=Tomoko
明香里=Akari
长井=Nagai
星野=Hoshino
石田=Ishida
切尔西=Chelsea
隆一=Ryuichi
斯特拉=Stella
加藤=Kato
健太郎=Kentaro
唐渡=Karawatari
洛克威尔=Rockwell
耀子=Yoko
神月=Kodzuki
未优=Miyuu
伊绪=Itori
小笠原=Ogasawara
黑岩=Kuroiwa
瑛美=Eimi
贵宫=Otaku
茅名=Mona
早弥=Hayami
间边=Sogoen
讃岐=Sanuki
梓川=Azusagawa
咲太=Sakuta
樱岛=Sakurajima
古贺=Koga
朋绘=Tomokata
双叶=Futaba
理央=Rio
国见=Kunimi
佑真=Yuuma
上里=Kamisato
沙希=Saki
文香=Fumika
翔子=Shoko
牧之原=Makinohara
前泽=Maesawa
藤泽=Fujisawa
拉普拉斯=Laplace
玲奈=Rena
香芝=Kashiba
阳介=Yosuke
日南子=Hinago
亚失=Aya
米山=Yoneyama
须野=Ijio
和花=Waka
丰浜=Hofuhama
花轮=Hanawa
江山友=Eyamato
理奈=Rina
米莉亚=Emilia
上板=Ageita
鹿野=Kano
琴美=Kotomi
花枫=Hanade
友部=Tomobe
美和子=Miwako
巴菲=Buffy
拉布拉多=Labrador
萨摩=Satsuma
八平=Hachibei
香月=Katsuki
雾子=Kiriko
染谷=Someya
佳乃=Yoshino
北见=Kitami
魅剑=Miryoken
柚姬=Yūki
万石=Mangoku
浦光=Pukari
路德=Luther
金恩=King
万石浦=Mangokuura
铁达尼=Titanic
长谷部=Hasebe
克丽欧佩脱拉=Cleopatra
熊唛=Makuma
诺艾儿=Noeli
琉特=Lute
堀田=Hotta
叶太=Fukuku
孝治=Koiji
相马=Soma
亮一=Ryoichi
艾露=Eru
AK 四七=AK-47
M 一 O=M10
雷明顿=Remington
M 七 ○○P=M700P
亚露=Aru
恩凯特=Enkarte
拉奇=Rach
弥夏=Mixia
阿尔泽特=Alzette
奇奇=Kiki
玛利=Mary
布莱德=Vlad
盖特=Gate
梅尔世=Mayer
邦妮=Bonnie
布鲁=Bruce
卡莲=Karen
毕晓普=Bishop
缪雅=Muya
马尔柯姆=Malcolm
柯尔特=Colt
札那第=Zarranis
佩肯宁=Percassen
榭拉丝=Xillias
多拉桂=Doraque
德拉古诺夫=Dragunov
拉比诺=Labino
拉弥亚=Lamia
席雅=Siya
艾诺尔=Aynor
美美亚=Mimia
菈菈=Lahah
蒙罗=Munroe
诺伊曼=Neumann
海勒姆=Hiram
马克沁=Maxim
雷克西=Rexee
弗斯库=Fuscu
佛劳伦斯=Palaure
琉顿=Luto
贝尔茨维尔=Beltville
沙罗曼达=Salamander
甘史密斯=Gunsmith
一乃=Ichino
森塚=Morizuka
雾花=Kirika
泽村=Sawamura
宗司=Muneshi
御园=Ogina
绫川=Rukawa
皐月=Satsuki
由枝=Youki
皋月=Satsuki
义贵=Shinji
龙也=Tatsuya
词香=Tangoka
月咏=Getsurei
异战=Betsusen
伊濑=Inose
深雪=Miiyuki
希多拉=Hydra
特尔柏雷=Terbalst
迪墉柏尔格=DeBerger
高尔巴=Gaulba
赛尔吉=Sergey
欧菲布斯=Opheus
维托里亚斯=Vitorias
希亚利=Hias
威斯=Weiss
萨尔威斯=Salweiss
奥斯特=Orsted
达喀尔勒斯=Darkahus
塔博鲁=Tabor
乌拉特=Ulat
希亚那=Hiana
哈鲁特=Harrut
巴尔库=Balco
森都=Shinto
卡西=Kasai
海尔德=Helder
西伯特=Siebert
弗利亚=Fora
史基德斯=Skiddle
布兰贝纳=Briblat
布莉塔=Balia
艾克斯=Aix
克斯=Alex
诺杉=Nushra
伦德斯=Lysander
佩脱勒斯=Peletus
泰瑞雅莎=Terrisa
妲莉内=Tallin
密卢=Milo
芙拉妮=Philany
吉欧=Geo
克林托斯=Clintos
锡尔克=Silke
威佐=Werz
马卡姆=Markham
海利德=Halide
梅罗尔=Mellisa
林布鲁特=Limbright
杜拉索斯=Durason
傅巴=Furb
广井=Hiroi
哈姆太郎=Hamutaro
百目鬼=Domeki
神谷=Kamiya
浩史=Hiroshi
公太郎=Kotaro
小田原=Odawara
须藤=Sudo
繁男=Shigeo
城尾=Shiroo
锐子=Mizuko
夏川=Natsukawa
志织=Kokorozashi
莉洁=Rize
阿伊娅=Aria
乌亚=Uya
拉米沙=Ramis
娜特娅=Natoia
戈亚=Goya
露娅=Rua
库娅=Kua
悠娅=Dura
索亚=Soya
普亚=Fua
艾娅=Ea
兹托勒伊亚=Surea
诺娅=Nonia
赫拉克勒斯=Heracles
普罗凯斯=Protare
卡维尔=Cavill
帕尔米亚=Paremia
法尔谢菈=Falchetia
里斯提昂=Ristian
法尔=Fal
阿尔特=Alte
阿尔特蕾娅=Altelia
路西德=Lucid
康丝坦丝=Constantine
瓦西雷乌斯=Vasilleus
隆加维尔=Longville
雷瑟提=Rethe
基萨奇=Kisarch
莱桑达=LaSand
缪尔=Mile
哈玛特=Hamat
昂巴特=Angbat
梅尔维娜=Melvina
卢森西欧=Luxembourg
席艾汀=Sianti
古斯塔=Gustav
琳达=Linda
加布拉=Gabrae
其萨基=Kisawi
石蕗=Tsuwabuki
春作=Harusaku
毒空木=Dokutsugi
美也子=Miyako
石 蕗=Tsuwabuki
时宗=Jishu
爱结=Aiji
藤原=Fujihara
手岛=Tejima
樱木=Sakuragi
鲶川=Kawanama
莲香=Hasu
和奥=Osutori
北原=Kitahara
吹子=Fukiko
布袋葵=Hotei Aoi
由香=Yuka
布袋=Hotei
秋海棠=Shukaido
柚理=Yuzuri
龙胆=Rindo
渡边=Watanabe
鲇川=Ayukawa
柚里=Yuzuri
菜花=Karifurawa
奥田=Okuda
仓桥=Kurahashi
立川=Tachikawa
天里=Tensato
李须=Risu
岩元=Iwamoto
谷屋=Taniya
叫门胁=Mengenkyo
莎布=Shabu
丽娜=Lina
大滝=Otaki
秀树=Hideki
真理奈=Marina
莎布丽娜=Sabrina
木下=Kinoshita
若林=Wakabayashi
饭纲=Konagae
奥利维尔=Oliver
和己=Wakami
瓦兹=Waz
莎罗娜=Sarah
尤尤那=Yuuna
露露娜=Lulia
迦兹纳=Zarand
黎尼克=Lenika
露拉=Lura
哥布尔=Goblin
梅娅尔=Mayaer
拉古尼尔=Lagunar
梅菈尔=Meyer
梅妮尔=Maynier
奥兰德=Orland
里根=Reagan
卡雷特=Karett
塔塔=Tata
巴多米尔=Bodomir
德利阿努斯=Deliante
贾尔冈=Jargang
格兰多=Grande
古雷葛里=Guligri
提切尔=Teacher
阿尔斯托罗=Alstroma
埃梅洛伊=Amerlus
赫尔提亚=Heredia
麦格=Magne
拉姆妮提斯=Raminitus
巴纳库尼斯=Banarkonus
露玛琪娜=Lumacia
维丝艾莉亚=Vesrian
巴多塔=Babuta
山形=Yamagata
辰巳=Tatsumi
琪可=Quike
卡露谢呀=Carolina
朵妮雅=Dolny
朱塞佩=Joseph
克力索普莱兹=Clarponte
巴尔迪奥=Baldio
卡露谢=Carolina
莱巴=Leba
谷莱巴=Gulea
谷拉法帝=Gulfadine
达拉卡贝=Dakralan
沙法以夫=Shafau
穆尔加=Muga
佐斯莱特=Zoilslete
穆尔加奈克=Mugarian
戴高勒斯=DeGaulles
波卡多=Bocado
帕斯=Pas
一宫=Ichinomiya
信吾=Shingo
威德林=Ulysses
鲍麦斯特=Bauminster
赫尔穆特=Helmut
埃里希=Erich
华特=Walter
艾格妮丝=Agnesi
科萝娜=Corona
布雷希洛德=Brechlord
亚美莉=Ameli
赫尔曼=Herman
布雷希柏格=Brechberg
阿玛迪斯=Amadeus
艾尔文=Alvin
希伦布兰德=Hilbrand
露易丝=Louise
尤兰妲=Uranda
奥蕾莉亚=Aurelia
欧佛维克=Ovorlik
布兰塔克=Brenta
林斯塔=Linst
艾弗烈=Avery
雷福德=Rayford
艾弗=Aver
艾戴里欧=Edileon
阿卡特=Akate
瓦伦=Walles
比尔霍夫=Billhook
卢德格尔=Ludeger
布朗特=Blount
蒙杰拉=Montgomery
卢克纳=Lukona
克林姆=Klimr
克里斯多夫=Christopher
阿姆斯壮=Armstrong
帕尔肯亚=Palkernia
古雷德=Gulodine
古兰多=Quran
米莉安=Millia
兰克=Frank
奥特曼=Aldman
赫克托=Hector
普林斯罕=Princeton
艾尔斯海姆=Ayervene
艾格尔梅=Egermei
艾德格=Adeger
霍恩海姆=Hornheim
黛安娜=Diana
赫米娜=Hermina
希德嘉=Sidja
鲍里斯=Boris
尤尔根=Jurgen
赛巴斯汀=Sebastian
静香=Shizuka
信五口=Shingokuchi
里涅海姆=Rhineheim
奥加斯=Organ
罗马努斯=Romanus
海特=Hite
迪哈特=Dihart
巴修米戴=Basirman
科琳娜=Colina
芙莉蒂=Fuliet
玛黛茶=Madiata
罗德里希=Rodrigo
伊修柏克=Yorkker
韦纳=Weiner
多米妮克=Daminae
贝恩德=Behead
卡尔海因兹=Karlhelm
瓦拉赫=Wallar
贝肯鲍尔=Beckenbauer
菲利浦=Philip
黛莉亚=Dalia
薇尔玛=Verma
海莲娜=Helena
罗普斯=Lupus
布雷希伯格=Brechberg
席格哈特=Sieghardt
卢默=Lumer
奥特玛=Otema
布莱布特罗伊=Gredary
孝巳=Komusu
绀野=Konno
鴫 原=Sigihara
翠=Midori
小田切=Odagiri
武本=Takemoto
有働=Udo
由香子=Yukako
濑户=Seto
濑户川=Setokawa
圭太=Keita
森岛=Morishima
高桥=Takahashi
岛原=Shimahara
三冢=Mitsuzuka
柘榴=Zakuro
壮马=Tsuyuma
久米=Kume
美知惠=Michimei
晴一郎=Seiichiro
昂大=Kota
永坚=Eikatai
辻=Tsuji
之臣=Daijin
佐佐冈=Sasaru
兵卫=Samurai
美浓部=Minoki
春喜=Haruki
奈绪=Nao
莲司=Renji
卡洛儿=Carol
安布劳斯=Ambrose
弗雷阿基斯塔=Frequista
加里乌斯=Garius
弗雷德=Fred
波普金斯=Popkins
威尔海姆=Willheim
艾布林卡=Abramka
吉列姆=Gillete
杜克利德=Douglas
娜塔莉雅=Natalie
克丽丝=Christie
伊丽莎白=Elizabeth
克莱=Clair
莉莉娅=Lilia
理查德=Richard
領家=Ryoka
高砂=Takasa
西堀=Nishibori
美穗=Miho
髙砂=Takasa
美樹=Miki
四谷=Yotsuya
別所=Bessho
瀨崎=Nazaki
三橋=Mihashi
田島=Tajima
宮前=Miyamae
大戶=Otofu
泉=Izumi
由美=Yumi
天沼=Amanuma
皐=Satsuki
上落合=Kamiochia
圓阿彌=Amiya
莲杖=Renjou
真咲=Masaki
百地=Momochi
纱良=Sara
八叶=Hachiyou
亚季=Aki
萌萌=Momo
新屋=Shinkyo
奈美=Nami
亮太=Ryouta
黑部=Kurobe
勇树=Yuki
唐岛=Karashima
九里=Kunori
八月=Hachigatsu
莲丈=Renjou
弥美=Watarabi
罗锁=Metoroku
水崎=Mizuzaki
萌香=Moka
小田桐=Odagiri
一真=Kazuma
笹井=Sasai
结奈=Jiena
四之宫=Shinomiya
瑠理=Ruri
瑠璃=Ruri
安莉=Anri
岸嶺=Kishimine
健吾=Kengo
天道=Tendo
瀨名=Sena
明雄=Akio
仁井谷=Niitani
佐奈惠=Sangumi
鷹三津=Takamitsu
宮美=Miyabi
班導=Hanshiro
日下部=Kusakabe
祐喜=Yuuki
奈森=Namori
茂男=Shigeo
琴野=Kotono
爱内=Uchinai
叶介=Kanokai
香神=Kashin
红绪=Akaito
阿普加斯=Applegarth
花菱=Hanabishi
卡戎=Karen
京佳=Kyoka
龙子=Ryuko
藤见川=Fujitagawa
和花菱=Wakahishi
华凪=Hanagi
神市=Kamishi
欧米茄=Omega
斋藤=Saito
香神神=Kashinshi
华子=Hanako
小华凪=Hanagi-chan
恋图=Renzu
加贺美=Kagami
钢=Hagane
希洛喵=Hironya
作希洛娜=Foronia
蜜斯蕾伊=Miselia
基尔莉丝=Corelia
雅斯提耶尔=Astière
冯斯拉姆=Von Slam
真白=Mashiro
夕希=Yuuki
蒲田=Kamata
阿德勒=Adler
莎菲尔=Shaphire
迪亚曼=Draman
比吕=Hiro
亚雷堤尔=Yalertier
奥黑=Ohea
福太郎=Futaro
赛伯洛斯=Cyberus
迪欧斯=Dios
萨利亚=Sarya
艾斯特雷亚=Estrella
葛兰兹=Glenz
丽兹=Liz
克劳狄司=Claudius
米哈耶鲁=Michael
塔密耶=Tamira
特里斯=Calitris
奥格尔=Ogre
奥尔迦=Orc
赛伯拉斯=Cyberos
罗伦思=Lorenzo
丘匹兹=Hillock
布鲁塔尔=Brutús
亚堤邬司=Yadishi
修瓦兹=Yuwara
基迦斯=Krias
古林达=Grind
巴欧姆=Baume
亚路特=Aldia
拜尔=Bayer
盖尔德姆=Geldam
贝尔克=Berke
鲁瑟=Ruth
雷希尔=Rachel
里菲泰因=Rivetain
特雷儿=Teleria
布拿达拉=Naerdala
奇欧尔克=Kaunika
特莱伊=Tehran
楼因=Louis
休特贝尔=Hughes
费尔瑟=Felsh
伊莎贝尔=Isabella
凯尔海特=Kaiserdin
库鲁特=Kalidus
雷伊=Ray
库罗涅=Kuraka
季里希=James
夏论=Harris
蜜斯缇=Mistea
葛莱亥特=Graham
奥茨巴卡尔=Otahr Bakar
大吐对=Daturac
卡鲁=Kar
朗吉尔=Laijir
休太岘=Hucatin
奇洛=Kyras
基古伊=Cagiús
迦达=Khârn
梅泰奥尔=Mêteor
库克里=Cookley
吉尔贝里斯=Grillberries
达尼耶鲁=Daniel
艾德华特=Edwalter
米璐耶=Milea
德里库司=Delired
涅可尔=Niekor
雷贝林古=Lebersian
克劳蒂雅=Claudia
罗可斯=Lamârcus
韩斯=Hans
武斯特=Worcester
伊特=Ire
佛劳斯=Fraus
德拉路=DeLain
巴奇=Bach
馥金=Furkin
沐宁=Machius
斐尔沃尔夫=Fellerwolf
瑟雷涅=Sạrene
汉尼尔=Hannier
奥特克雷尔=Attrilune
史沃罗夫=Swarovski
巴尔=Baél
嘉里乌斯=Galiodus
哈亚特=Hayato
米兹尔奇=Mizelich
哈萝特=Harrow
夏露拉=Shialura
霞泽=Siare
斯纳伊=Snyder
普尼尔=Purnie
比克托莉亚=Birtoria
亚莉亚=Aria
琳迪斯=Lindsay
贝尔蒂=Belle
奥尔托莉亚=Orthoria
阿尔黛儿=Alderane
淇露露=Kiruru
蒂媚蒂=Demide
琪露露=Kiruru
林迪思=Lindsay
维多莉亚=Britoria
贝尔帝=Belle
希尔瓦娜=Sylvania
蕾德=Reed
芙儿蒂娜=Fulia
琳妮=Lenny
雷西斯=Resus
毕雅=Bea
千岁=Chitose
池田=Ikeda
十胜=Tokachi
千惠里=Chieri
闪亮亮=Kirara
玛莉茉=Marima
富良=Tomiyoshi
野眹=Yasei
丹玛莉=Tamari
千闪=Chiki
留萌=Rumoi
三石=Mitsuishi
辛德瑞拉=Cinderella
苍衣=Kura
雪乃=Yukino
时 槻=Tokotsuki
白野=Shirono
飒姬=Sachi
敷岛=Shishima
佐和野=Yoshushi
杜塚=Moridzuka
戴尔塔=Delta
田上=Tagami
神狩屋=Kamiriya
夏木=Natsuki
梦见子=Yumeko
真衣子=Maiko
夏惠=Natsume
真衣=Mai
佩罗=Perrault
叶耶=Kanou
沟口=Mizoguchi
黑矶=Kurosuru
风乃=Kazede
可南子=Kanako
修司=Shuji
冰汐=Nishinokori
泉命=Izuminochi
柳泽=Yanagisawa
莉普=Reishi
红爱=Akaai
蕾迪=Leidi
二美=Futami
须磨=Suma
克莉莫尔=Claymore
一美=Kazumi
相羽=Aiba
梅许=Mess
音恩=Otoon
命声=Inochigo
御杖代=Mitsutshiro
红姊=Aka-nee
茶姆=Chamo
莉噗=Reifu
柯鲁=Karl
二堂=Nidou
巴博拉=Barbara
阿德瑞娜=Adeline
伽奇=Grace
凯纳=Kean
吉贝克=Gibbick
艾利克=Airita
芭芭拉=Barbara
赛西利欧=Cecilian
克鲁特=Crete
爱尔美=Aemer
莉希雅=Lithia
法尔海特=Falhalt
尼可拉斯=Nicolas
克莱茵=Klein
歇洛亚=Chelsea
乔纳斯=Jonas
莱纳斯=Latra
霍华德=Howard
利克=Luke
马里奥=Mario
礼子=Reiko
华尔特=Walther
亚洛伊斯=Yaliare
弗兰兹=Frank
埃吉利亚=Arqualita
艾利亚斯=Eliane
雷纳德=Leonard
拉格兰=Lagrange
索蕾优=Solar
布鲁兰德=Brewer
碧娜啦=Binaa
格拉迪亚=Gladia
汉普敦=Hampton
拉尔德=Lalde
古贝克=Gubar
克劳德=Claude
库兹玛=Kurema
赛班斯=Saints
玛希亚=Masiah
哈德森=Hudson
瓦伦铁诺=Valentine
莱茵哈特=Rhinehart
艾尔莎=Elsa
贝尔纳多=Bernardo
莱因哈特=Reinhardt
亚多博格=Adolfberg
博格=Berg
蜜奈=Hina
波特洛克=Potlock
翡冷翠=Florence
山铜=Azurite
伽尔马=Garma
赛妮亚=Tanya
艾琉席恩=Alysian
娜塔=Natta
戌见=Inumiru
驰郎=Chiran
伊佳=Ika
少影=Shokage
娜达=Nara
式森=Shikimori
和树=Shoshiki
宫间=Mamiya
夕菜=Yūna
玖里子=Kyuragi
神城=Kamishiro
迪丝特尔=Diettle
威贝尔=Weiber
斯坦布尔=Steinbrough
菲娅路卡=Frelica
伊庭=Iba
淳子=Junko
科尼斯堡=Cornelius
吕贝克=Lübeck
奥古洛=Oglo
加里宁格勒=Kaliningrad
羽田=Haneda
马迪尔斯=Matthew
艾鲁弗雷登=Igladon
莉西亚=Livia
路德银=Lupercal
阿克=Aker
格欧鲁古=Geogrian
艾歇尔=Acharyr
欧露塔=Aulur
卡斯托=Kasto
巴鲁伽斯=Barghas
阿伊莎=Aisha
托莫耶=Tomorye
茱娜=Juna
哈库亚=Hakuya
琳娜=Lina
塞琳娜=Serena
彭鸠=Parjur
艾尔弗雷登=Alfreden
马基雅维利=Machiavelli
西园寺=Saionji
一斗=Ittō
八田=Hatta
来珠=Bizuni
南德原=Nandemoto
北条=Hojo
皇斗=Sumerato
友佳=Yuka
真田=Sanada
武彦=Takehiko
友佳梨子=Yukashiko
夕鹤=Yukuen
帝诺拉迪翁=DeNorwhich
一文字=Hitomogi
五十岛=Igashima
七濑=Nanase
伊田=Ida
一三=Ichisan
狼神=Okashi
鹰雄=Akira
鹫津=Igumatsu
吉平=Yoshihara
多明迪亚卢斯=Dominica
赖夫尼察=Renolian
傅巴氏=Furbat
佛洛摩亚士=Florader
锡尔克教=Silkerian
五郎=Goro
彼太=Hita
拉契=Rachel
四季=Shiki
露露卡=Ruruko
悠艾=Yougi
埃特=Ete
盖札=Card
菲卢比斯特=Felibus
伽兹=Gaz
阿卡莉=Akari
托鲁=Toru
阿丘拉=Acura
迪鲁索兰特=Delsorant
康拉德=Conrad
修坦因梅茨=Steinmetz
庞巴迪=Bombardier
克里曼=Kleeman
阿尔图鲁=Athur
吉雷特=Gillette
柴卡=Chaika
特拉班特=Trabant
阿巴特=Abarth
罗伯托=Roberto
阿鲁贝里克=Alberic
俾马克=Vermac
兹伊塔=Zita
薇薇=Viivi
库维尔=Koenigsegg
玛提乌斯=Matheus
霍洛拜因=Holopainen
阿夫特托尔=Autotor
雷奥纳鲁多=Leonardo
华丝明=Jasmine
乌洛=Oslo
多米妮卡=Dominica
斯柯达=Skoda
露琪叶=Lucie
嘉依卡=Chaika
亚裘拉=Akari
托勒庞特=Trabant
贾兹=Gaz
阿图尔=Athur
戴尔索兰特=Delsorant
菲尔毕斯特=Felibus
基烈特=Gillette
伊芙索姆=Eversome
亚伯力克=Alberic
芷依塔=Zita
布鲁萨斯可=Brusasco
奇伊=Guy
阿弗多托尔=Autotor
马特乌斯=Matheus
卡拉威=Callaway
荷罗派涅=Holopainen
特拉=Stola
多明妮卡=Dominica
斯考达=Skoda
露婕=Lucie
芙蕾多妮卡=Fredrica
斯坎尼亚=Scania
科尼柯赛克=Koenigsegg
斯坦梅茨=Steinmetz
拉德米欧=Ladmere
哈丝敏=Jasmine
布芙丹=Bogdan
赛尔玛=Selma
佩利梅拉尔=Perimeral
嘉伊卡=Chaika
里加尔图=Ricardo
加瓦尔尼=Garvani
葛拉特=Glatt
蓝斯亚=Larsira
赛特拉=Seetra
特奥巴登=Deobard
史特拉托斯=Stellaris
希杰达=Hireda
佛登=Fuden
李奥拉多=Leonardo
基里尔=Krill
娥苏拉=Erza
拉德克=Radeka
鲁波鲁=Rupus
妮娃=Niva
莱妲=Lada
伊热夫斯克=Izhmash
史帝芬=Steven
哈尔特根=Haltgen
克劳蒂亚=Claudia
爱琳娜=Alina
伊琳娜=Irina
阿巴尔特=Abarth
胡戈=Hugo
卡尔森=Carlson
坎帕尼亚=Campagnia
肯沃斯=Kenworth
多妮卡=Donica
亚袭拉=Acula
班奈狄克=Bennick
巫罗=Oslo
路克=Luke
毕耶露婕=Talisia
达西亚=Daria
克菈丝娜雅=Kristina
凌志=Lexus
费雷尔=Ferrer
尤莉耶=Juliana
高登=Gordon
阿列克谢=Alexei
塞尔玛=Selma
葛伦=Glen
克沃特=Kewort
米修雅=Michaua
冬克沃特=Doukas
道尔=Doyle
塔力士=Tyler
迪亚玛特=Tiamat
龙彦=Tatsuhiko
德拉格尼尔=Delagnier
妮菲露堤雅=Niferna
德摩纳尔=DeMonaer
奥迪奴斯=Ordinus
克莉丝汀娜=Christina
拉克丽玛=Lacrida
贝洁=Bae
悠皮特利乌斯=DePetrius
式垣=Shikaki
布里希嘉曼=Bristolian
罗兰德=Rolando
法娜=Fann
罗瑟=Rothsch
梅鲁吉=Merus
迪欧尼斯=Dionides
帕加鲁纳=Paganar
普婷=Pudding
萝亚=Loya
戴尔塔修=Daenar
布雷兹=Bretz
钱德勒=Chandler
美索不达米亚=Mesopotamia
凯妮=Kenia
艾巴德尼格尔=Albanicaer
莱西=Lacey
伊尔=Ilis
卡格斯拉=Cádiz
萨里奴=Salis
拉蔻儿=Lakea
格温=Gwen
卢卡尔=Lukal
米斯特哈温德=Mist Havenland
奥尔德巴=Elda
多利阿尔德=Dalier
菲利亚诺=Fioriana
赛罗=Cyrus
菲诺=Fiora
玛丽露=Malisa
泽尔德纳特=Zeldnnath
卡迪娜=Kardina
埃鲁福尔=Elvenfort
哈尔姆巴克=Halbaker
柯琳=Celine
尼尔瓦里奥=Niwerger
克缇卡=Katia
修缇卡=Tatia
宵泣草=Sigcloud
范达尔=Fardale
鲁弗斯=Rufus
艾尔西=Elsie
阿尔凯因=Alkine
罗姆奈利乌斯=Romanius
启太=Keita
伊芙=Eve
八百谷=Yaotani
羽奈=Hanea
张间=Chorumu
合梨=Gonashi
时雨=Shiame
亚恋=Aijia
响弥=Ross
风晴=Sani
